geo_code,alt_geo_code,geo_name,cohort_0_to_4,cohort_5_to_19,cohort_20_to_44,cohort_45_to_64,cohort_65_and_older,total_population,total_dwellings
1001101,1001101,"Division No. 1, Subd. V",0,0,0,0,0,0,140
1001105,1001105,Portugal Cove South,0,10,15,80,30,135,91
1001113,1001113,Trepassey,10,25,70,200,165,470,356
1001120,1001120,St. Shott's,0,0,0,30,25,55,52
1001124,1001124,"Division No. 1, Subd. U",50,220,390,615,340,1615,1630
1001126,1001126,Cape Broyle,10,100,115,155,105,485,291
1001131,1001131,Renews-Cappahayden,5,20,40,140,90,295,346
1001136,1001136,Fermeuse,10,45,45,115,115,330,178
1001140,1001140,Port Kirwan,0,0,15,15,20,50,64
1001144,1001144,Aquaforte,5,10,10,30,35,90,71
1001149,1001149,Ferryland,10,45,65,175,100,395,254
1001155,1001155,"Division No. 1, Subd. W",5,30,80,205,120,440,893
1001169,1001169,St. Vincent's-St. Stephen's-Peter's River,0,40,45,145,90,320,221
1001174,1001174,Gaskiers-Point La Haye,10,20,40,85,90,245,145
1001178,1001178,St. Mary's,5,35,40,150,125,355,216
1001181,1001181,Riverhead,5,20,30,90,40,185,153
1001186,1001186,Admirals Beach,0,15,20,40,50,125,80
1001192,1001192,St. Joseph's,0,15,25,45,50,135,114
1001197,1001197,Mount Carmel-Mitchells Brook-St. Catherine's,5,25,50,150,115,345,302
1001203,1001203,"Division No. 1, Subd. X",10,50,90,210,140,500,754
1001207,1001207,Colinet,0,5,5,35,20,65,73
1001214,1001214,"Division No. 1, Subd. C",0,5,0,45,40,90,140
1001219,1001219,Branch,5,30,40,95,60,230,174
1001225,1001225,Point Lance,0,15,15,50,5,85,48
1001228,1001228,St. Bride's,5,25,40,120,70,260,169
1001234,1001234,"Division No. 1, Subd. B",10,45,65,150,90,360,380
1001240,1001240,Placentia,110,465,785,1230,915,3505,1852
1001254,1001254,Fox Harbour,10,40,55,100,55,260,133
1001259,1001259,"Division No. 1, Subd. A",10,50,105,335,225,725,726
1001263,1001263,Long Harbour-Mount Arlington Heights,5,20,35,80,50,190,163
1001267,1001267,Southern Harbour,5,45,65,165,85,365,213
1001270,1001270,Arnold's Cove,30,130,215,325,235,935,537
1001274,1001274,Come By Chance,0,30,60,100,40,230,125
1001277,1001277,Sunnyside,10,60,80,150,95,395,286
1001281,1001281,Chance Cove,0,15,30,110,85,240,150
1001285,1001285,Norman's Cove-Long Cove,20,90,130,240,190,670,339
1001289,1001289,Chapel Arm,20,70,105,160,110,465,244
1001293,1001293,"Division No. 1, Subd. Y",50,160,295,360,255,1120,857
1001298,1001298,Whitbourne,30,160,190,285,210,875,527
1001304,1001304,"Division No. 1, Subd. E",115,440,670,1005,720,2950,1575
1001308,1001308,Whiteway,20,35,80,125,105,365,165
1001312,1001312,Heart's Delight-Islington,20,80,125,240,205,670,388
1001316,1001316,Heart's Desire,10,30,40,90,45,215,124
1001321,1001321,"Division No. 1, Subd. F",10,85,120,175,165,555,352
1001325,1001325,Heart's Content,0,35,40,150,105,330,217
1001328,1001328,New Perlican,5,15,20,90,50,180,163
1001332,1001332,Winterton,5,50,70,145,170,440,277
1001335,1001335,Hant's Harbour,5,30,60,130,110,335,210
1001339,1001339,"Division No. 1, Subd. G",45,210,360,745,500,1860,1337
1001343,1001343,Old Perlican,20,85,185,210,130,630,288
1001347,1001347,Bay de Verde,10,55,75,130,125,395,216
1001352,1001352,Small Point-Adam's Cove-Blackhead-Broad Cove,5,50,75,165,95,390,308
1001357,1001357,"Division No. 1, Subd. H",15,45,90,160,95,405,227
1001361,1001361,Salmon Cove,25,110,150,250,150,685,329
1001365,1001365,Victoria,65,305,470,605,370,1815,810
1001370,1001370,Carbonear,190,745,1235,1555,1130,4855,2166
1001374,1001374,"Division No. 1, Subd. I",10,45,85,85,60,285,150
1001375,1001375,Bryant's Cove,20,60,115,140,70,405,162
1001379,1001379,Harbour Grace,95,430,715,1035,725,3000,1469
1001385,1001385,Upper Island Cove,60,235,365,555,330,1545,685
1001391,1001391,"Division No. 1, Subd. J",0,0,0,0,0,0,0
1001394,1001394,Bishop's Cove,0,35,65,100,85,285,147
1001396,1001396,Spaniard's Bay,125,440,745,840,520,2670,1180
1001405,1001405,"Division No. 1, Subd. K",0,0,0,0,0,0,139
1001409,1001409,Bay Roberts,300,1090,1675,1820,1135,6020,2658
1001415,1001415,"Division No. 1, Subd. L",45,160,240,270,225,940,487
1001421,1001421,"Division No. 1, Subd. M",45,165,255,410,195,1070,1440
1001426,1001426,North River,15,85,150,200,115,565,286
1001429,1001429,Clarke's Beach,60,220,340,410,530,1560,642
1001434,1001434,South River,30,75,160,230,155,650,335
1001437,1001437,Cupids,15,125,160,270,170,740,364
1001441,1001441,"Division No. 1, Subd. N",15,55,90,135,65,360,300
1001446,1001446,Brigus,25,95,165,250,185,720,446
1001452,1001452,"Division No. 1, Subd. O",10,80,130,305,145,670,1170
1001456,1001456,Colliers,30,75,170,245,145,665,424
1001461,1001461,Conception Harbour,30,105,170,250,140,695,392
1001464,1001464,Avondale,25,110,160,220,130,645,373
1001469,1001469,Harbour Main-Chapel's Cove-Lakeview,40,160,255,405,210,1070,509
1001472,1001472,Holyrood,140,355,680,780,510,2465,1106
1001485,1001485,Conception Bay South,1430,4730,8575,7815,3660,26210,10553
1001490,1001490,"Division No. 1, Subd. R",5,15,45,135,110,310,188
1001494,1001494,Wabana,85,330,440,775,505,2135,1150
1001504,1001504,Portugal Cove-St. Philip's,495,1530,2620,2480,1030,8155,3215
1001505,1001505,Pouch Cove,105,400,675,590,295,2065,868
1001507,1001507,Flatrock,120,310,635,470,145,1680,641
1001509,1001509,Torbay,450,1610,2760,2285,810,7915,3005
1001511,1001511,Logy Bay-Middle Cove-Outer Cove,105,410,600,755,350,2220,827
1001512,1001512,Bauline,25,80,150,140,55,450,174
1001517,1001517,Paradise,1530,4230,8555,5305,1760,21380,8662
1001519,1001519,St. John's,4840,15805,39950,30300,17970,108865,52410
1001542,1001542,Mount Pearl,910,3340,7375,7495,3850,22970,10381
1001551,1001551,Petty Harbour-Maddox Cove,40,175,290,295,150,950,394
1001557,1001557,Bay Bulls,100,270,510,400,225,1505,589
1001559,1001559,Witless Bay,130,265,560,445,230,1630,634
1001565,1001565,"Division No. 1, Subd. D",0,10,10,40,20,80,142
1002001,1002001,"Division No. 2, Subd. E",10,35,55,90,60,250,296
1002002,1002002,Lewin's Cove,25,90,140,185,105,545,253
1002005,1002005,Burin,90,375,585,830,440,2320,1145
1002006,1002006,"Division No. 2, Subd. F",0,25,35,45,25,130,153
1002008,1002008,St. Lawrence,40,185,265,435,275,1200,601
1002009,1002009,"Division No. 2, Subd. G",0,0,0,0,0,0,113
1002011,1002011,Lawn,20,105,135,235,120,615,298
1002012,1002012,Lamaline,5,45,55,105,70,280,159
1002013,1002013,Lord's Cove,5,15,30,70,35,155,96
1002014,1002014,Point May,5,30,55,95,50,235,116
1002015,1002015,Point au Gaul,5,10,25,30,30,100,40
1002016,1002016,"Division No. 2, Subd. H",0,10,20,85,65,180,365
1002017,1002017,Frenchman's Cove,5,20,20,65,55,165,134
1002018,1002018,Fortune,55,205,285,485,385,1415,782
1002019,1002019,Grand Bank,65,280,465,780,715,2305,1158
1002021,1002021,Garnish,20,75,135,205,140,575,292
1002022,1002022,"Division No. 2, Subd. D",10,25,40,90,60,225,119
1002023,1002023,Winterland,10,65,100,150,60,385,191
1002024,1002024,Marystown,205,885,1370,1830,1025,5315,2383
1002025,1002025,Fox Cove-Mortier,10,40,70,115,55,290,155
1002026,1002026,"Division No. 2, Subd. I",5,15,10,50,50,130,107
1002027,1002027,Bay L'Argent,5,30,60,75,70,240,132
1002029,1002029,"Division No. 2, Subd. J",0,0,0,0,0,0,0
1002030,1002030,Grand le Pierre,5,30,60,95,45,235,107
1002031,1002031,"Division No. 2, Subd. C",15,65,110,250,135,575,498
1002033,1002033,Rushoon,10,30,50,95,65,250,127
1002034,1002034,Parkers Cove,5,35,65,100,60,265,127
1002036,1002036,Terrenceville,15,70,130,170,100,485,239
1002037,1002037,Red Harbour,0,35,45,65,40,185,83
1002039,1002039,English Harbour East,5,20,30,60,25,140,73
1002040,1002040,Baine Harbour,10,15,25,30,35,115,61
1002041,1002041,St. Bernard's-Jacques Fontaine,10,50,105,170,120,455,220
1002044,1002044,"Division No. 2, Subd. L",0,0,0,0,0,0,361
1002048,1002048,"Division No. 2, Subd. K",5,50,100,195,210,560,447
1002055,1002055,Little Bay East,0,10,25,45,45,125,66
1003001,1003001,"Division No. 3, Subd. A",0,0,0,0,0,0,109
1003002,1003002,Rencontre East,10,30,30,45,25,140,77
1003003,1003003,St. Jacques-Coomb's Cove,20,85,145,210,130,590,310
1003004,1003004,Belleoram,30,70,85,140,40,365,175
1003005,1003005,Pool's Cove,5,30,40,65,60,200,96
1003006,1003006,"Division No. 3, Subd. B",0,0,0,0,0,0,58
1003008,1003008,Harbour Breton,60,260,395,610,305,1630,703
1003009,1003009,"Division No. 3, Subd. C",0,0,0,0,0,0,0
1003010,1003010,Seal Cove (Fortune Bay),5,20,35,75,110,245,134
1003011,1003011,Hermitage-Sandyville,5,50,90,160,125,430,217
1003012,1003012,Gaultois,0,25,35,55,30,145,102
1003014,1003014,"Division No. 3, Subd. D",5,10,60,125,65,265,529
1003018,1003018,Milltown-Head of Bay d'Espoir,15,80,130,295,220,740,381
1003019,1003019,St. Alban's,25,190,230,475,280,1200,604
1003020,1003020,Morrisville,0,10,15,50,30,105,50
1003021,1003021,"Division No. 3, Subd. E",0,15,30,45,15,105,81
1003024,1003024,"Division No. 3, Subd. F",10,20,25,50,35,140,188
1003026,1003026,Ramea,5,40,60,215,125,445,277
1003028,1003028,Burgeo,25,105,240,560,385,1315,655
1003031,1003031,"Division No. 3, Subd. H",20,110,160,275,140,705,313
1003032,1003032,Isle aux Morts,10,85,130,260,180,665,331
1003033,1003033,Burnt Islands,10,90,155,250,110,615,257
1003034,1003034,Channel-Port aux Basques,175,530,910,1425,1040,4080,1954
1003038,1003038,"Division No. 3, Subd. I",0,15,15,40,20,90,53
1003042,1003042,"Division No. 3, Subd. J",0,0,0,25,20,45,27
1003045,1003045,Rose Blanche-Harbour le Cou,10,35,55,160,145,405,266
1003801,1003801,Samiajij Miawpukek,50,205,335,295,65,950,342
1004001,1004001,"Division No. 4, Subd. A",35,220,285,650,510,1700,1375
1004006,1004006,"Division No. 4, Subd. B",25,130,210,440,390,1195,948
1004011,1004011,"Division No. 4, Subd. C",35,105,170,265,170,745,490
1004013,1004013,St. George's,50,180,285,455,240,1210,597
1004016,1004016,"Division No. 4, Subd. D",25,105,175,350,210,865,646
1004017,1004017,Gallants,0,0,5,5,25,35,72
1004018,1004018,Stephenville Crossing,60,225,370,625,425,1705,833
1004019,1004019,Stephenville,305,945,1770,2130,1470,6620,3366
1004020,1004020,Kippens,55,350,430,745,455,2035,832
1004021,1004021,Port au Port East,10,90,115,200,155,570,286
1004022,1004022,"Division No. 4, Subd. E",75,310,490,715,375,1965,1027
1004033,1004033,Cape St. George,35,145,185,295,185,845,410
1004037,1004037,Lourdes,10,80,110,145,105,450,234
1004042,1004042,Port au Port West-Aguathuna-Felix Cove,10,40,95,175,120,440,222
1005001,1005001,"Division No. 5, Subd. A",10,35,45,115,70,275,407
1005003,1005003,"Division No. 5, Subd. G",10,40,75,185,145,455,459
1005004,1005004,Deer Lake,235,830,1380,1600,1195,5240,2300
1005005,1005005,Jackson's Arm,15,30,55,110,80,290,172
1005006,1005006,Howley,5,10,25,90,60,190,122
1005007,1005007,"Division No. 5, Subd. E",0,10,15,100,95,220,297
1005008,1005008,Hampden,5,65,75,170,90,405,218
1005009,1005009,Reidville,20,85,135,170,105,515,219
1005010,1005010,"Division No. 5, Subd. F",30,145,215,295,145,830,687
1005011,1005011,Steady Brook,15,70,115,140,100,440,204
1005012,1005012,Pasadena,185,540,935,1200,765,3625,1582
1005014,1005014,Cormack,15,95,130,235,130,605,288
1005015,1005015,Gillams,15,70,120,135,85,425,190
1005016,1005016,"Division No. 5, Subd. C",15,40,80,95,55,285,404
1005017,1005017,Massey Drive,90,355,610,475,85,1615,624
1005018,1005018,Corner Brook,815,2775,5580,6110,4525,19805,9395
1005019,1005019,"Division No. 5, Subd. D",0,0,0,0,0,0,230
1005020,1005020,Humber Arm South,50,230,430,580,295,1585,721
1005022,1005022,McIvers,15,90,115,190,130,540,236
1005023,1005023,Cox's Cove,25,100,155,260,130,670,338
1005024,1005024,Lark Harbour,15,80,105,175,140,515,297
1005025,1005025,Meadows,20,70,155,220,165,630,270
1005028,1005028,Hughes Brook,15,45,100,80,30,270,94
1005030,1005030,Irishtown-Summerside,55,190,370,460,335,1410,616
1005033,1005033,Mount Moriah,30,140,205,255,120,750,308
1005035,1005035,York Harbour,20,55,60,130,60,325,246
1006001,1006001,"Division No. 6, Subd. D",15,65,125,260,215,680,769
1006003,1006003,Norris Arm,15,115,135,305,165,735,392
1006008,1006008,"Division No. 6, Subd. E",5,25,50,70,50,200,631
1006009,1006009,Gander,560,2065,3555,3420,2100,11700,5167
1006011,1006011,Appleton,25,90,135,215,100,565,246
1006012,1006012,Glenwood,45,125,195,260,165,790,362
1006014,1006014,"Division No. 6, Subd. C",15,75,125,280,185,680,829
1006015,1006015,Northern Arm,10,55,75,175,105,420,218
1006017,1006017,Grand Falls-Windsor,590,2250,3840,4470,3015,14165,6406
1006019,1006019,Bishop's Falls,125,430,735,1145,720,3155,1502
1006021,1006021,Peterview,25,150,215,295,155,840,313
1006022,1006022,Botwood,95,420,640,920,805,2880,1302
1006026,1006026,Badger,15,120,155,250,170,710,325
1006028,1006028,Millertown,5,5,20,40,20,90,66
1006029,1006029,"Division No. 6, Subd. A",5,15,20,40,45,125,351
1006031,1006031,Buchans,10,80,100,250,210,650,417
1007001,1007001,"Division No. 7, Subd. M",45,230,405,735,560,1975,1183
1007006,1007006,"Division No. 7, Subd. L",40,150,310,430,300,1230,728
1007009,1007009,"Division No. 7, Subd. K",50,195,320,440,270,1275,707
1007013,1007013,Clarenville,375,1150,1945,1715,1105,6290,2809
1007014,1007014,"Division No. 7, Subd. J",10,55,75,195,120,455,440
1007015,1007015,Trinity (Trinity Bay),5,20,35,70,50,180,132
1007016,1007016,Port Rexton,15,50,65,120,80,330,250
1007018,1007018,"Division No. 7, Subd. I",0,0,5,30,25,60,48
1007020,1007020,Elliston,5,45,65,120,75,310,201
1007022,1007022,Trinity Bay North,60,200,365,710,470,1805,933
1007023,1007023,Bonavista,120,450,825,1180,875,3450,1749
1007024,1007024,"Division No. 7, Subd. G",15,30,55,155,85,340,294
1007025,1007025,Keels,0,10,10,25,20,65,53
1007026,1007026,Duntara,0,0,0,0,0,0,42
1007027,1007027,King's Cove,0,5,15,55,20,95,81
1007028,1007028,"Division No. 7, Subd. F",15,80,130,340,275,840,674
1007031,1007031,"Division No. 7, Subd. E",95,345,575,985,630,2630,1682
1007032,1007032,Musgravetown,25,85,125,175,150,560,285
1007036,1007036,Port Blandford,20,70,100,225,180,595,328
1007037,1007037,Traytown,15,35,45,100,55,250,149
1007038,1007038,"Division No. 7, Subd. D",0,25,40,105,80,250,734
1007039,1007039,Sandy Cove,0,5,15,40,50,110,92
1007040,1007040,Terra Nova,0,10,5,35,20,70,156
1007041,1007041,Happy Adventure,5,15,30,90,60,200,149
1007042,1007042,Eastport,15,60,95,165,170,505,334
1007043,1007043,Sandringham,10,25,45,95,60,235,125
1007044,1007044,Glovertown,80,290,475,680,560,2085,948
1007045,1007045,"Division No. 7, Subd. N",5,5,5,25,25,65,166
1007046,1007046,Salvage,5,10,15,60,35,125,104
1007047,1007047,Gambo,85,265,505,650,490,1995,967
1007048,1007048,St. Brendan's,5,15,25,80,35,160,137
1007049,1007049,Hare Bay,30,160,220,335,220,965,460
1007050,1007050,Centreville-Wareham-Trinity,25,150,200,415,360,1150,561
1007051,1007051,"Division No. 7, Subd. B",0,0,0,0,0,0,483
1007054,1007054,Greenspond,10,25,75,105,65,280,176
1007056,1007056,"Division No. 7, Subd. A",0,15,25,60,25,125,180
1007057,1007057,Dover,30,95,150,265,110,650,287
1007060,1007060,New-Wes-Valley,55,270,415,860,575,2175,1157
1007067,1007067,Indian Bay,10,25,30,65,40,170,113
1008001,1008001,"Division No. 8, Subd. M",0,20,25,65,30,140,175
1008004,1008004,Lumsden,20,65,110,200,110,505,295
1008006,1008006,Musgrave Harbour,20,155,225,355,235,990,501
1008008,1008008,"Division No. 8, Subd. L",100,470,695,1065,715,3045,1993
1008011,1008011,Carmanville,20,105,200,230,175,730,378
1008024,1008024,Change Islands,0,15,15,90,80,200,196
1008026,1008026,"Division No. 8, Subd. I",10,30,45,80,70,235,142
1008029,1008029,Crow Head,0,20,30,65,60,175,116
1008031,1008031,"Division No. 8, Subd. H",55,225,420,695,505,1900,1171
1008032,1008032,Cottlesville,25,25,50,95,65,260,148
1008033,1008033,Summerford,30,120,215,325,215,905,467
1008035,1008035,Twillingate,60,250,415,790,690,2205,1261
1008036,1008036,"Division No. 8, Subd. G",5,40,70,170,150,435,556
1008037,1008037,Campbellton,10,50,80,195,115,450,268
1008038,1008038,Birchy Bay,15,70,110,230,120,545,260
1008039,1008039,Comfort Cove-Newstead,15,40,75,160,110,400,248
1008040,1008040,Baytona,5,30,60,85,75,255,129
1008042,1008042,"Division No. 8, Subd. F",30,135,200,335,235,935,492
1008043,1008043,Embree,30,100,170,230,175,705,331
1008044,1008044,Lewisporte,115,480,760,975,1080,3410,1582
1008045,1008045,Little Burnt Bay,10,35,70,90,85,290,144
1008046,1008046,"Division No. 8, Subd. E",15,55,80,255,140,545,785
1008047,1008047,Point of Bay,0,15,25,70,45,155,120
1008048,1008048,Leading Tickles,5,35,45,130,80,295,150
1008049,1008049,Point Leamington,10,65,90,245,185,595,334
1008052,1008052,"Division No. 8, Subd. D",0,0,0,0,0,0,39
1008053,1008053,Pilley's Island,10,35,55,105,75,280,155
1008054,1008054,Triton,35,165,250,350,180,980,454
1008055,1008055,Brighton,10,25,40,90,20,185,98
1008056,1008056,Lushes Bight-Beaumont-Beaumont North,5,5,15,95,55,175,154
1008058,1008058,"Division No. 8, Subd. C",0,40,50,215,130,435,845
1008059,1008059,South Brook,10,60,100,190,120,480,256
1008060,1008060,Robert's Arm,30,125,175,275,205,810,380
1008061,1008061,Springdale,125,425,655,885,860,2950,1306
1008062,1008062,Port Anson,0,10,20,60,35,125,109
1008063,1008063,Little Bay,0,10,15,40,40,105,72
1008064,1008064,Little Bay Islands,0,5,5,25,35,70,117
1008065,1008065,"Division No. 8, Subd. P",5,25,40,155,110,335,354
1008066,1008066,Beachside,0,10,25,45,45,125,80
1008067,1008067,"Division No. 8, Subd. O",5,50,75,125,60,315,183
1008069,1008069,King's Point,25,95,170,250,130,670,332
1008070,1008070,Nippers Harbour,5,15,20,35,20,95,64
1008071,1008071,Burlington,15,50,80,115,50,310,144
1008072,1008072,Middle Arm,15,80,135,165,80,475,195
1008073,1008073,Tilt Cove,0,0,0,0,0,0,8
1008074,1008074,"Division No. 8, Subd. A",5,40,60,155,60,320,795
1008075,1008075,Fleur de Lys,5,25,40,105,65,240,157
1008076,1008076,LaScie,30,145,220,305,195,895,429
1008077,1008077,Brent's Cove,0,20,25,70,25,140,85
1008078,1008078,Pacquet,0,15,15,75,60,165,97
1008079,1008079,Baie Verte,60,205,350,405,300,1320,646
1008091,1008091,Seal Cove (White Bay),5,25,65,110,100,305,173
1008092,1008092,Coachman's Cove,5,10,25,35,35,110,70
1008093,1008093,Westport,5,25,40,65,45,180,118
1008095,1008095,Ming's Bight,5,45,95,120,50,315,137
1008096,1008096,Woodstock,5,20,30,75,65,195,97
1008098,1008098,Miles Cove,0,0,5,55,30,90,62
1008099,1008099,Fogo Island,65,320,435,895,535,2250,1460
1009001,1009001,"Division No. 9, Subd. F",0,10,0,35,20,65,297
1009004,1009004,Englee,15,65,95,195,160,530,260
1009007,1009007,Roddickton-Bide Arm,35,185,205,345,235,1005,418
1009008,1009008,Conche,0,15,30,70,55,170,125
1009009,1009009,"Division No. 9, Subd. A",0,5,0,55,60,120,573
1009010,1009010,Trout River,25,90,140,180,125,560,276
1009011,1009011,"Woody Point, Bonne Bay",5,20,35,105,100,265,225
1009012,1009012,Norris Point,15,85,110,255,195,660,356
1009013,1009013,Rocky Harbour,25,135,220,360,205,945,523
1009015,1009015,Daniel's Harbour,10,30,35,110,60,245,168
1009016,1009016,Cow Head,15,50,85,160,120,430,255
1009017,1009017,Parson's Pond,10,45,60,120,105,340,207
1009018,1009018,Hawke's Bay,10,35,70,140,65,320,167
1009019,1009019,Port Saunders,25,100,145,255,150,675,312
1009020,1009020,St. Pauls,10,20,60,95,50,235,111
1009021,1009021,"Division No. 9, Subd. C",65,325,535,1025,590,2540,1249
1009022,1009022,Port au Choix,20,100,165,330,175,790,408
1009023,1009023,Anchor Point,10,60,80,95,55,300,130
1009024,1009024,Flower's Cove,5,35,35,95,115,285,133
1009026,1009026,Bird Cove,0,15,35,80,40,170,93
1009028,1009028,Main Brook,10,25,35,95,90,255,155
1009029,1009029,St. Anthony,85,345,560,735,535,2260,1040
1009030,1009030,Glenburnie-Birchy Head-Shoal Brook,5,25,35,90,60,215,189
1009031,1009031,"Division No. 9, Subd. D",15,50,110,300,160,635,558
1009032,1009032,St. Lunaire-Griquet,20,85,135,220,145,605,267
1009034,1009034,Cook's Harbour,5,10,20,45,45,125,87
1009035,1009035,Raleigh,5,15,25,75,60,180,102
1009037,1009037,Sally's Cove,0,0,0,0,0,0,30
1009039,1009039,Goose Cove East,0,20,45,85,25,175,79
1009041,1009041,"Division No. 9, Subd. H",5,20,30,55,40,150,221
1009042,1009042,Bellburns,0,0,5,20,30,55,46
1009047,1009047,"Division No. 9, Subd. G",0,0,10,15,5,30,148
1009048,1009048,River of Ponds,5,25,35,100,50,215,138
1010001,1010001,"Division No. 10, Subd. A",5,5,20,30,20,80,38
1010002,1010002,L'Anse au Loup,20,85,135,185,130,555,240
1010003,1010003,Red Bay,0,15,30,65,45,155,92
1010004,1010004,L'Anse-au-Clair,5,35,45,85,55,225,103
1010005,1010005,Forteau,10,55,75,135,130,405,193
1010006,1010006,West St. Modeste,5,20,20,35,35,115,61
1010007,1010007,Pinware,0,10,10,45,10,75,50
1010008,1010008,"Division No. 10, Subd. B",15,65,110,115,65,370,242
1010009,1010009,Port Hope Simpson,15,70,130,140,60,415,176
1010010,1010010,St. Lewis,0,35,45,70,40,190,89
1010011,1010011,Mary's Harbour,5,55,85,135,65,345,154
1010012,1010012,"Cartwright, Labrador",20,60,105,170,65,420,221
1010013,1010013,Charlottetown (Labrador),15,50,75,115,40,295,128
1010020,1010020,"Division No. 10, Subd. C",70,135,220,105,25,555,153
1010022,1010022,North West River,30,75,150,200,90,545,277
1010025,1010025,Happy Valley-Goose Bay,520,1420,2850,2415,905,8110,3271
1010029,1010029,"Division No. 10, Subd. D",50,165,255,220,15,705,369
1010032,1010032,Labrador City,435,1345,2825,2030,610,7245,3474
1010034,1010034,Wabush,145,365,745,465,170,1890,950
1010042,1010042,"Division No. 10, Subd. E",0,0,0,0,0,0,0
1010801,1010801,Natuashish 2,125,310,345,125,30,935,228
1010802,1010802,Sheshatshiu 3,120,370,350,155,35,1030,249
1011005,1011005,"Division No. 11, Subd. C",0,0,0,0,0,0,0
1011010,1011010,Rigolet,25,65,105,80,30,305,127
1011015,1011015,Postville,5,35,55,50,30,175,112
1011020,1011020,Makkovik,25,65,130,115,30,365,148
1011030,1011030,Hopedale,45,115,220,165,35,580,196
1011035,1011035,Nain,90,265,420,265,80,1120,362
1011040,1011040,"Division No. 11, Subd. E",0,0,0,0,0,0,0
1101001,1101001,Lot 64,40,140,260,290,200,930,532
1101002,1101002,Murray Harbour,0,40,55,75,95,265,177
1101004,1101004,Murray River,10,50,70,100,70,300,182
1101006,1101006,Lot 63,30,135,205,295,140,805,422
1101008,1101008,Lot 61,40,95,185,245,175,740,455
1101009,1101009,Lot 59,60,165,315,405,250,1195,634
1101011,1101011,Lot 66,25,40,70,45,20,200,79
1101014,1101014,Lot 51,45,120,255,235,140,795,337
1101016,1101016,Lot 52,35,120,195,265,135,750,352
1101018,1101018,Montague,65,310,495,495,605,1970,933
1101019,1101019,Lot 53,20,105,135,155,85,500,285
1101021,1101021,Cardigan,15,50,70,95,45,275,131
1101022,1101022,"Kings, Royalty",20,50,60,90,70,290,203
1101024,1101024,Georgetown,25,105,125,190,100,545,297
1101026,1101026,Lot 54,10,55,70,120,75,330,173
1101028,1101028,Lot 55,15,60,100,140,85,400,284
1101029,1101029,Lot 56,20,50,85,115,55,325,244
1101031,1101031,Lot 43,25,115,165,225,165,695,469
1101032,1101032,Lot 44,45,130,195,260,140,770,507
1101034,1101034,Lot 45,30,105,130,120,70,455,246
1101036,1101036,Souris,45,160,235,320,305,1065,529
1101038,1101038,Lot 46,20,75,80,90,80,345,281
1101039,1101039,Lot 47,10,75,100,165,115,465,400
1101041,1101041,Lot 42,5,40,50,75,65,235,164
1101042,1101042,Lot 41,15,60,85,145,80,385,265
1101044,1101044,St. Peters Bay,20,30,60,80,45,235,127
1101046,1101046,Lot 40,15,70,110,165,70,430,217
1101048,1101048,Morell,20,45,80,90,65,300,137
1101049,1101049,Lot 39,25,95,155,215,125,615,554
1101050,1101050,Morell 2,0,0,0,0,0,0,9
1101051,1101051,Lot 38,25,100,150,175,85,535,401
1102001,1102001,Lot 62,10,105,180,165,85,545,336
1102004,1102004,Lot 60,15,40,85,95,75,310,207
1102006,1102006,Lot 58,25,60,120,150,90,445,292
1102008,1102008,Lot 57,60,140,250,290,240,980,443
1102009,1102009,Lot 50,45,170,310,265,140,930,376
1102012,1102012,Lot 49,60,200,315,360,165,1100,483
1102014,1102014,Lot 48,140,435,620,585,275,2055,811
1102026,1102026,Lot 31,105,385,510,530,245,1775,676
1102028,1102028,Lot 65,125,480,650,730,360,2345,1320
1102029,1102029,Lot 30,40,170,240,250,140,840,438
1102030,1102030,Rocky Point 3,5,15,25,15,0,60,19
1102031,1102031,Lot 29,45,155,210,300,200,910,665
1102032,1102032,Victoria,0,10,5,20,30,65,64
1102033,1102033,Meadowbank,10,60,75,120,90,355,200
1102034,1102034,Crapaud,15,40,70,75,120,320,133
1102036,1102036,Lot 67,45,175,240,245,130,835,363
1102037,1102037,Clyde River,30,140,165,220,100,655,270
1102038,1102038,Lot 20,30,115,195,300,210,850,665
1102039,1102039,Lot 21,30,90,195,330,205,850,752
1102040,1102040,Miltonvale Park,55,165,320,415,185,1140,493
1102041,1102041,Lot 22,25,105,160,220,90,600,295
1102042,1102042,Lot 23,55,180,260,325,150,970,440
1102043,1102043,Hunter River,15,70,85,100,105,375,164
1102044,1102044,Lot 24,95,285,435,595,315,1725,975
1102045,1102045,Resort Mun. Stan.B.-Hope R.-Bayv.-Cavend.-N.Rust.,5,50,50,135,85,325,350
1102046,1102046,North Rustico,15,70,125,185,205,600,344
1102048,1102048,Brackley,15,75,85,135,65,375,148
1102049,1102049,Lot 33,80,225,390,455,185,1335,667
1102050,1102050,Union Road,20,30,55,75,25,205,79
1102051,1102051,Breadalbane,10,35,50,65,10,170,76
1102052,1102052,Lot 34,185,500,880,860,425,2850,1449
1102054,1102054,Lot 35,85,280,525,520,225,1635,859
1102056,1102056,Lot 36,60,145,215,195,120,735,407
1102057,1102057,Scotchfort 4,20,50,90,40,10,210,63
1102058,1102058,Lot 37,40,95,200,160,80,575,315
1102059,1102059,Mount Stewart,10,30,70,70,35,215,114
1102065,1102065,Winsloe South,15,45,65,75,35,235,86
1102070,1102070,Warren Grove,15,80,85,120,50,350,140
1102075,1102075,Charlottetown,1585,5505,11935,9965,7100,36090,17193
1102080,1102080,Stratford,580,1820,3105,2635,1565,9705,4097
1102085,1102085,Cornwall,300,1135,1655,1455,800,5345,2132
1103001,1103001,Lot 28,55,150,215,255,165,840,565
1103005,1103005,Borden-Carleton,35,130,195,235,130,725,376
1103006,1103006,Lot 27,25,130,170,255,150,730,415
1103008,1103008,Kinkora,15,70,110,95,60,350,154
1103009,1103009,Lot 26,45,170,265,340,185,1005,658
1103011,1103011,Lot 25,55,215,280,395,215,1160,520
1103012,1103012,Lot 19,75,310,480,595,340,1800,811
1103014,1103014,Kensington,55,265,400,490,405,1615,781
1103015,1103015,Bedeque and Area,15,60,95,75,55,300,128
1103016,1103016,Lot 18,45,160,240,375,245,1065,827
1103018,1103018,Sherbrooke,5,15,25,60,40,145,94
1103019,1103019,Lot 17,30,130,165,200,70,595,244
1103023,1103023,Linkletter,10,55,70,115,55,305,136
1103024,1103024,Miscouche,55,170,250,245,155,875,372
1103025,1103025,Summerside,695,2510,3895,4355,3375,14830,6946
1103026,1103026,Lot 15,45,160,265,410,235,1115,701
1103027,1103027,Abrams Village,15,50,80,70,60,275,121
1103028,1103028,Lot 16,40,125,200,250,100,715,336
1103029,1103029,Wellington,25,40,80,100,160,405,176
1103031,1103031,Lot 14,30,160,205,240,105,740,346
1103032,1103032,Lot 13,40,135,205,195,120,695,347
1103033,1103033,Tyne Valley,10,40,50,70,55,225,105
1103034,1103034,Lot 12,50,155,250,230,130,815,381
1103035,1103035,Lennox Island 1,25,90,110,85,15,325,116
1103036,1103036,Lot 11,25,90,140,170,75,500,223
1103038,1103038,Lot 10,15,40,65,100,40,260,125
1103041,1103041,Lot 6,50,140,210,245,165,810,367
1103042,1103042,O'Leary,40,120,160,215,270,805,387
1103044,1103044,Lot 9,15,50,70,90,55,280,139
1103046,1103046,Lot 8,35,105,125,165,120,550,312
1103048,1103048,Lot 7,20,65,120,160,105,470,267
1103049,1103049,Lot 5,45,235,350,405,245,1280,922
1103051,1103051,Lot 4,55,195,305,350,210,1115,499
1103052,1103052,Alberton,50,145,260,305,380,1140,554
1103054,1103054,Lot 3,30,160,205,255,110,760,356
1103056,1103056,Lot 2,70,270,410,445,270,1465,647
1103057,1103057,St. Louis,0,0,15,20,20,55,36
1103058,1103058,Lot 1,75,320,415,570,275,1655,798
1103059,1103059,Tignish,35,100,145,195,240,715,334
1103062,1103062,Miminegash,5,25,40,45,50,165,72
1201001,1201001,Barrington,290,975,1760,2165,1455,6645,3494
1201004,1201004,Clark's Harbour,35,110,205,270,145,765,407
1201006,1201006,Shelburne,155,540,915,1555,1110,4275,2635
1201008,1201008,Shelburne,85,270,395,545,445,1740,909
1201009,1201009,Lockeport,10,70,70,190,175,515,320
1202001,1202001,Argyle,315,1185,1960,2560,1870,7890,3821
1202004,1202004,Yarmouth,380,1590,2430,3230,2210,9840,4981
1202006,1202006,Yarmouth,305,955,1705,1925,1630,6520,3470
1202040,1202040,Yarmouth 33,15,40,40,50,15,160,70
1203001,1203001,Clare,205,1005,1755,2875,2185,8025,4681
1203004,1203004,Digby,250,1070,1620,2445,1710,7095,4048
1203006,1203006,Digby,75,260,425,660,635,2055,1145
1203009,1203009,Bear River (Part) 6,20,40,45,35,10,150,53
1204009,1204009,Ponhook Lake 10,0,0,0,0,0,0,7
1204010,1204010,Queens,325,1375,2160,3525,2915,10300,6586
1204015,1204015,Wildcat 12,0,0,0,0,0,0,15
1205001,1205001,"Annapolis, Subd. D",130,445,690,1070,665,3000,1805
1205002,1205002,Bear River (Part) 6,0,0,0,0,0,0,0
1205004,1205004,"Annapolis, Subd. A",195,755,1150,1975,1805,5880,3412
1205006,1205006,Bear River 6B,0,0,0,0,0,0,3
1205008,1205008,Annapolis Royal,10,40,70,145,235,500,346
1205009,1205009,"Annapolis, Subd. B",145,665,890,1465,1275,4440,2342
1205014,1205014,"Annapolis, Subd. C",220,755,1185,1725,1050,4935,2488
1205016,1205016,Middleton,70,260,435,505,565,1835,995
1206001,1206001,Lunenburg,890,3350,5795,8840,5990,24865,14038
1206004,1206004,Bridgewater,340,1230,2255,2410,2315,8550,4299
1206006,1206006,Lunenburg,70,270,460,660,800,2260,1206
1206008,1206008,Mahone Bay,35,110,165,330,385,1025,571
1206009,1206009,Chester,415,1285,2255,3570,2775,10300,6492
1206011,1206011,Gold River 21,10,25,40,15,0,90,34
1206014,1206014,Pennal 19,0,0,0,0,0,0,8
1206016,1206016,New Ross 20,0,0,0,0,0,0,0
1207001,1207001,"Kings, Subd. A",1245,3765,6195,6880,4145,22230,10635
1207002,1207002,Cambridge 32,10,35,50,30,10,135,56
1207004,1207004,Berwick,90,345,525,700,850,2510,1071
1207011,1207011,"Kings, Subd. C",370,1245,2140,2595,1745,8095,3817
1207012,1207012,Kentville,295,1045,1755,1775,1395,6265,2891
1207016,1207016,"Kings, Subd. B",535,2080,3165,3845,2230,11855,5567
1207021,1207021,"Kings, Subd. D",215,720,1205,1865,1210,5215,2529
1207024,1207024,Wolfville,130,510,1375,1035,1145,4195,2585
1207027,1207027,Glooscap 35,10,15,35,25,5,90,36
1208001,1208001,West Hants,760,2525,4070,5045,2970,15370,7175
1208002,1208002,Windsor,180,585,835,1000,1055,3655,1715
1208008,1208008,East Hants,1195,4060,6455,7295,3445,22450,9930
1208014,1208014,Indian Brook 14,105,310,350,265,70,1100,382
1209019,1209019,Cole Harbour 30,0,25,45,60,65,195,123
1209029,1209029,Shubenacadie 13,0,0,0,0,0,0,0
1209034,1209034,Halifax,19785,63060,140200,116995,63095,403135,187338
1209037,1209037,Beaver Lake 17,0,0,0,0,0,0,5
1209038,1209038,Sheet Harbour 36,0,0,0,0,0,0,9
1209800,1209800,Wallace Hills 14A,0,0,0,0,0,0,3
1210001,1210001,"Colchester, Subd. C",635,2285,3430,4255,2490,13095,6031
1210002,1210002,Stewiacke,75,205,345,440,305,1370,681
1210003,1210003,Millbrook 27,70,210,300,195,95,870,309
1210006,1210006,Truro,580,1640,3610,3360,3085,12275,6574
1210008,1210008,"Colchester, Subd. B",830,3370,5065,6195,4080,19540,9564
1210012,1210012,"Colchester, Subd. A",155,540,830,1155,795,3475,2219
1211001,1211001,"Cumberland, Subd. A",60,255,350,625,645,1935,1389
1211002,1211002,Parrsboro,40,165,235,405,350,1195,773
1211006,1211006,"Cumberland, Subd. B",260,1020,1685,2240,1655,6860,3558
1211009,1211009,"Cumberland, Subd. C",195,760,1170,1835,1310,5270,4003
1211011,1211011,Amherst,415,1510,2470,2765,2250,9410,4745
1211012,1211012,Oxford,60,195,310,385,255,1205,597
1211014,1211014,"Cumberland, Subd. D",115,540,790,1445,1270,4160,3380
1212001,1212001,"Pictou, Subd. A",180,880,1330,2145,1535,6070,3863
1212004,1212004,Pictou,130,470,730,965,885,3180,1627
1212006,1212006,"Pictou, Subd. B",265,935,1495,2060,1420,6175,2769
1212008,1212008,Westville,170,675,1025,1040,710,3620,1698
1212009,1212009,Stellarton,215,795,1190,1190,815,4205,2018
1212011,1212011,"Pictou, Subd. C",350,1270,2055,2940,1830,8445,4546
1212014,1212014,New Glasgow,435,1385,2405,2670,2195,9090,4640
1212016,1212016,Trenton,130,400,660,790,495,2475,1206
1212019,1212019,Fisher's Grant 24,35,150,190,90,20,485,158
1212023,1212023,Merigomish Harbour 31,0,0,0,0,0,0,0
1213001,1213001,St. Mary's,70,290,420,760,685,2225,1667
1213004,1213004,Guysborough,160,560,780,1665,1510,4675,3196
1213008,1213008,Mulgrave,20,130,150,255,170,725,327
1214001,1214001,"Antigonish, Subd. A",455,1470,2195,2515,1650,8285,4222
1214002,1214002,Antigonish,165,555,1385,1130,1140,4375,2596
1214006,1214006,"Antigonish, Subd. B",285,1170,1650,2005,1185,6295,2890
1214010,1214010,Pomquet And Afton 23,35,110,145,65,5,360,134
1215001,1215001,"Inverness, Subd. C",105,510,690,1070,800,3175,2022
1215002,1215002,Port Hawkesbury,130,545,880,915,750,3220,1554
1215006,1215006,"Inverness, Subd. B",195,810,1040,1570,1310,4925,2775
1215008,1215008,Whycocomagh 2,90,280,290,155,20,835,270
1215011,1215011,"Inverness, Subd. A",175,625,1025,1735,1510,5070,3255
1216001,1216001,"Richmond, Subd. C",100,425,705,1090,830,3150,1621
1216006,1216006,"Richmond, Subd. A",130,535,835,1180,1130,3810,2083
1216011,1216011,"Richmond, Subd. B",35,145,290,555,480,1505,1251
1216014,1216014,Chapel Island 5,45,155,180,90,45,515,167
1217008,1217008,Membertou 28B,95,295,375,200,55,1020,349
1217020,1217020,Eskasoni 3,395,1075,1180,605,180,3435,1114
1217030,1217030,Cape Breton,3690,13640,23955,30680,22315,94280,45742
1218001,1218001,"Victoria, Subd. B",150,520,775,1405,1145,3995,2599
1218003,1218003,Wagmatcook 1,55,170,175,125,30,555,166
1218006,1218006,"Victoria, Subd. A",115,395,580,870,615,2575,1672
1301001,1301001,Saint Martins,45,175,285,395,215,1115,609
1301002,1301002,St. Martins,5,45,60,80,80,270,198
1301004,1301004,Simonds,195,695,1190,1260,490,3830,1617
1301006,1301006,Saint John,3245,10335,21020,20005,12960,67565,33801
1301016,1301016,Musquash,60,180,340,395,230,1205,600
1302001,1302001,Grand Manan,5,30,25,50,35,145,103
1302004,1302004,Campobello Island,50,145,215,275,190,875,616
1302006,1302006,West Isles,35,105,220,260,170,790,467
1302008,1302008,Lepreau,20,85,175,240,180,700,507
1302011,1302011,Pennfield,95,370,570,745,390,2170,996
1302012,1302012,Blacks Harbour,40,135,240,290,180,885,411
1302014,1302014,Clarendon,0,0,10,20,10,40,90
1302016,1302016,Saint George,115,385,625,765,455,2345,1254
1302018,1302018,St. George,75,250,420,455,305,1505,681
1302021,1302021,Saint Patrick,30,65,150,285,155,685,545
1302024,1302024,Saint Andrews,20,85,130,200,125,560,312
1302026,1302026,Saint Andrews,65,245,400,530,530,1770,1008
1302028,1302028,Saint Croix,30,105,155,225,135,650,368
1302031,1302031,Dufferin,25,80,160,170,145,580,256
1302034,1302034,Saint Stephen,85,280,490,665,330,1850,820
1302037,1302037,St. Stephen,215,775,1180,1280,970,4420,2206
1302039,1302039,Saint James,60,195,305,435,200,1195,570
1302042,1302042,Saint David,70,225,360,555,325,1535,743
1302044,1302044,Dumbarton,10,50,80,125,80,345,195
1302052,1302052,Grand Manan,145,355,685,710,470,2365,1365
1303001,1303001,Blissville,35,125,220,285,160,825,378
1303004,1303004,Gladstone,20,75,125,160,70,450,239
1303005,1303005,Tracy,25,95,160,215,115,610,262
1303006,1303006,Fredericton Junction,40,110,185,175,170,680,298
1303008,1303008,Lincoln,460,1195,2535,2185,800,7175,3019
1303011,1303011,Burton,275,1000,1585,1590,665,5115,2020
1303012,1303012,Oromocto,770,1695,4275,1645,845,9230,3900
1303013,1303013,Oromocto 26,20,75,100,60,15,270,103
1303014,1303014,Sheffield,30,125,175,270,210,810,542
1303016,1303016,Maugerville,75,335,570,565,285,1830,765
1303018,1303018,Northfield,25,85,150,215,140,615,327
1304001,1304001,Petersville,30,90,205,220,145,690,325
1304004,1304004,Gagetown,15,40,90,100,60,305,155
1304005,1304005,Gagetown,25,75,140,245,230,715,339
1304006,1304006,Hampstead,15,40,55,85,80,275,185
1304008,1304008,Wickham,10,75,70,120,150,425,469
1304011,1304011,Cambridge,25,75,120,250,185,655,617
1304013,1304013,Cambridge-Narrows,15,50,70,225,195,555,659
1304014,1304014,Johnston,15,80,110,195,160,560,392
1304016,1304016,Brunswick,5,25,35,75,55,195,159
1304018,1304018,Waterborough,15,95,145,325,245,825,885
1304021,1304021,Canning,30,95,200,340,260,925,755
1304022,1304022,Minto,80,315,495,750,660,2300,1170
1304024,1304024,Chipman,20,105,195,350,245,915,541
1304025,1304025,Chipman,35,135,195,380,360,1105,638
1305001,1305001,Hammond,5,40,60,90,60,255,153
1305004,1305004,Upham,70,225,325,425,220,1265,579
1305006,1305006,Hampton,175,490,775,915,450,2805,1157
1305007,1305007,Hampton,275,790,1120,1180,925,4290,1709
1305008,1305008,Rothesay,10,80,90,85,55,320,136
1305011,1305011,Westfield,80,305,525,710,335,1955,952
1305014,1305014,Kingston,125,460,750,1005,570,2910,1671
1305015,1305015,Grand Bay-Westfield,235,885,1415,1565,845,4945,2029
1305016,1305016,Norton,75,225,360,430,210,1300,536
1305018,1305018,Norton,90,260,395,420,220,1385,567
1305021,1305021,Sussex,120,490,650,850,405,2515,1050
1305022,1305022,Sussex,220,700,1140,1170,1045,4275,2147
1305023,1305023,Sussex Corner,65,235,350,430,375,1455,675
1305024,1305024,Waterford,20,85,135,145,95,480,260
1305026,1305026,Cardwell,65,225,335,470,260,1355,709
1305028,1305028,Havelock,65,185,250,345,200,1045,550
1305031,1305031,Studholm,165,625,920,1115,700,3525,1481
1305034,1305034,Springfield,70,275,390,480,310,1525,885
1305036,1305036,Kars,5,45,60,135,80,325,352
1305038,1305038,Greenwich,60,130,250,360,255,1055,560
1305045,1305045,Rothesay,560,2250,3220,3555,2065,11650,4816
1305057,1305057,Quispamsis,965,3990,5265,5305,2710,18235,6596
1306001,1306001,Hopewell,25,95,150,235,140,645,319
1306003,1306003,Riverside-Albert,10,65,65,105,105,350,168
1306004,1306004,Harvey,5,45,55,125,120,350,248
1306006,1306006,Alma,10,20,60,70,50,210,202
1306007,1306007,Alma,0,0,0,0,0,0,3
1306008,1306008,Elgin,35,125,185,305,250,900,595
1306011,1306011,Hillsborough,45,190,340,470,270,1315,649
1306014,1306014,Coverdale,210,755,1250,1500,755,4470,1806
1306020,1306020,Riverview,905,3480,5875,5570,3855,19685,8537
1306025,1306025,Hillsborough,60,225,325,375,285,1270,584
1307001,1307001,Westmorland,25,135,215,320,220,915,596
1307002,1307002,Port Elgin,5,100,80,115,110,410,196
1307004,1307004,Botsford,35,115,190,400,335,1075,1045
1307005,1307005,Beaubassin East / Beaubassin-est,285,820,1705,2260,1300,6370,3388
1307007,1307007,Cap-Pelé,70,285,765,780,520,2420,1078
1307008,1307008,Sackville,75,160,305,400,240,1180,553
1307009,1307009,Sackville,220,855,1380,1595,1285,5335,3010
1307011,1307011,Dorchester,15,60,100,160,95,430,215
1307012,1307012,Dorchester,15,70,420,430,165,1100,235
1307013,1307013,Memramcook,235,685,1395,1600,860,4775,2119
1307014,1307014,Fort Folly 1,0,5,20,10,15,50,22
1307016,1307016,Shediac,215,600,1220,1680,1075,4790,2973
1307019,1307019,Moncton,470,1580,2945,3340,1475,9810,4036
1307022,1307022,Moncton,3620,10855,25010,19665,12735,71885,35380
1307024,1307024,Salisbury,170,580,940,1070,630,3390,1430
1307028,1307028,Salisbury,125,435,635,605,470,2270,974
1307029,1307029,Petitcodiac,90,255,345,370,325,1385,619
1307045,1307045,Dieppe,1400,4570,9135,6685,3575,25365,10829
1307052,1307052,Shediac,250,810,1725,1985,1880,6650,3141
1308001,1308001,Dundas,135,520,965,1385,900,3905,2529
1308002,1308002,Cocagne,105,310,650,935,655,2655,1418
1308003,1308003,Buctouche 16,10,25,45,10,0,90,40
1308004,1308004,Wellington,115,365,745,1130,740,3095,1716
1308005,1308005,Bouctouche,90,275,570,815,600,2350,1179
1308006,1308006,Saint Mary,85,245,485,710,430,1955,969
1308007,1308007,Saint-Antoine,85,225,490,510,405,1715,764
1308008,1308008,Saint-Paul,35,135,215,290,160,835,399
1308010,1308010,Harcourt,5,35,70,120,110,340,274
1308012,1308012,Huskisson,0,0,0,0,0,0,11
1308014,1308014,Weldford,45,190,310,485,305,1335,743
1308015,1308015,Richibucto 15,180,515,660,450,130,1935,767
1308016,1308016,Richibucto,55,250,430,690,450,1875,1137
1308017,1308017,Rexton,30,120,180,265,240,835,428
1308018,1308018,Richibucto,45,150,280,405,400,1280,719
1308019,1308019,Saint-Charles,65,255,480,735,450,1985,1083
1308020,1308020,Indian Island 28,15,40,60,25,15,155,56
1308021,1308021,Saint-Louis,50,225,370,660,500,1805,785
1308022,1308022,Saint-Louis de Kent,30,100,190,285,250,855,442
1308024,1308024,Acadieville,25,75,160,275,165,700,388
1308026,1308026,Carleton,20,75,145,270,195,705,404
1309001,1309001,Hardwicke,50,280,510,835,515,2190,1217
1309004,1309004,Glenelg,65,260,410,500,330,1565,742
1309006,1309006,Chatham,25,75,130,170,105,505,262
1309011,1309011,Derby,30,140,220,320,270,980,466
1309014,1309014,Nelson,35,170,240,320,195,960,431
1309016,1309016,Rogersville,25,145,250,460,235,1115,543
1309017,1309017,Rogersville,35,140,215,360,415,1165,565
1309018,1309018,Blackville,65,295,540,655,450,2005,974
1309019,1309019,Blackville,35,210,240,310,150,945,417
1309021,1309021,Blissfield,20,60,85,165,120,450,268
1309022,1309022,Doaktown,30,120,170,250,230,800,425
1309023,1309023,Red Bank 4,15,60,125,85,35,320,179
1309026,1309026,Southesk,60,245,425,605,345,1680,834
1309027,1309027,Upper Miramichi,85,320,445,720,645,2215,1291
1309028,1309028,Northesk,75,345,540,800,520,2280,1068
1309031,1309031,Newcastle,55,185,270,400,215,1125,522
1309034,1309034,Big Hole Tract 8 (South Half),5,5,25,15,5,55,33
1309035,1309035,Eel Ground 2,45,125,175,135,45,525,234
1309036,1309036,Alnwick,130,475,870,1320,850,3645,1882
1309038,1309038,Neguac,70,220,415,560,410,1675,783
1309044,1309044,Esgenoôpetitj 14,105,295,440,275,60,1175,401
1309047,1309047,Tabusintac 9,0,0,0,0,0,0,7
1309050,1309050,Miramichi,780,2615,4540,5445,4175,17555,8248
1310001,1310001,New Maryland,155,490,820,800,340,2605,998
1310002,1310002,New Maryland,210,890,1100,1300,675,4175,1513
1310004,1310004,Manners Sutton,60,285,400,635,395,1775,1123
1310005,1310005,Harvey,20,70,90,100,95,375,158
1310006,1310006,McAdam,50,175,240,400,285,1150,618
1310007,1310007,McAdam,5,10,20,20,15,70,63
1310008,1310008,North Lake,5,20,25,85,90,225,387
1310011,1310011,Canterbury,15,100,95,205,115,530,456
1310012,1310012,Canterbury,15,80,100,85,65,345,152
1310013,1310013,Meductic,10,35,45,60,25,175,78
1310014,1310014,Dumfries,15,45,65,105,110,340,334
1310016,1310016,Prince William,35,120,205,355,195,910,672
1310017,1310017,Hanwell,250,1005,1320,1580,580,4735,1856
1310018,1310018,Kingsclear,155,520,800,890,455,2820,1069
1310019,1310019,Kingsclear 6,40,125,185,105,35,490,186
1310021,1310021,Queensbury,45,165,300,425,250,1185,587
1310024,1310024,Southampton,55,290,350,475,310,1480,719
1310025,1310025,Millville,10,45,65,75,70,265,152
1310026,1310026,Bright,185,605,920,1030,560,3300,1440
1310028,1310028,Douglas,360,1140,1770,1955,925,6150,2546
1310031,1310031,Saint Marys,295,955,1510,1510,575,4845,1944
1310032,1310032,Fredericton,2935,8940,21035,14810,10495,58215,28431
1310034,1310034,Devon 30,100,300,355,220,60,1035,323
1310036,1310036,Stanley,35,135,190,305,170,835,413
1310037,1310037,Stanley,15,75,80,125,110,405,182
1310054,1310054,Nackawic,30,180,210,255,265,940,455
1311001,1311001,Richmond,85,220,360,420,240,1325,586
1311004,1311004,Woodstock,120,415,655,685,345,2220,930
1311005,1311005,Woodstock 23,15,70,100,105,40,330,129
1311006,1311006,Woodstock,265,835,1500,1470,1140,5210,2470
1311008,1311008,Northampton,90,325,475,565,265,1720,762
1311011,1311011,Brighton,90,285,455,610,305,1745,814
1311012,1311012,Hartland,55,150,235,290,245,975,402
1311014,1311014,Wakefield,135,515,745,865,500,2760,1181
1311018,1311018,Wilmot,45,180,245,385,170,1025,449
1311019,1311019,Centreville,35,100,140,150,135,560,278
1311021,1311021,Simonds,20,80,105,155,115,475,203
1311024,1311024,Peel,65,230,355,355,205,1210,496
1311026,1311026,Aberdeen,25,120,175,295,165,780,503
1311027,1311027,Florenceville-Bristol,80,305,460,460,295,1600,723
1311028,1311028,Kent,90,400,535,730,395,2150,953
1311030,1311030,Bath,15,90,110,140,125,480,224
1311031,1311031,Wicklow,95,325,455,535,275,1685,720
1312001,1312001,Andover,55,145,195,305,190,890,407
1312002,1312002,Aroostook,10,50,80,95,70,305,165
1312004,1312004,Perth,30,165,225,390,270,1080,575
1312006,1312006,Perth-Andover,60,255,360,435,465,1575,769
1312007,1312007,Tobique 20,80,240,320,235,70,945,389
1312008,1312008,Gordon,55,200,335,560,330,1480,786
1312009,1312009,Plaster Rock,50,145,215,325,295,1030,531
1312011,1312011,Lorne,10,55,70,195,130,460,407
1312014,1312014,Denmark,65,255,365,495,300,1480,733
1312016,1312016,Grand Falls,50,215,280,400,175,1120,506
1312019,1312019,Grand Falls / Grand-Sault,225,775,1310,1740,1295,5345,2622
1312021,1312021,Drummond,125,385,620,735,300,2165,938
1312023,1312023,Drummond,40,105,180,260,155,740,350
1313001,1313001,Saint-André,50,195,315,385,185,1130,448
1313002,1313002,Saint-André,30,125,240,260,120,775,341
1313004,1313004,Saint-Léonard,25,150,280,380,130,965,422
1313006,1313006,Saint-Léonard,55,235,335,390,295,1310,603
1313008,1313008,Notre-Dame-de-Lourdes,10,30,70,110,70,290,125
1313011,1313011,Sainte-Anne,45,110,255,390,170,970,509
1313012,1313012,Sainte-Anne-de-Madawaska,40,125,245,320,215,945,436
1313014,1313014,Rivière-Verte,30,90,190,270,150,730,358
1313015,1313015,Rivière-Verte,35,100,195,265,115,710,346
1313018,1313018,Saint-Basile,30,85,145,225,90,575,270
1313020,1313020,St. Basile 10,15,30,65,75,30,215,98
1313022,1313022,Saint-Joseph,55,230,445,540,280,1550,715
1313024,1313024,Saint-Jacques,55,225,390,640,280,1590,748
1313027,1313027,Edmundston,620,2255,4120,5350,4250,16595,8051
1313028,1313028,Madawaska,0,0,0,0,0,0,4
1313032,1313032,Saint-Hilaire,15,95,125,170,75,480,196
1313033,1313033,St. Hilaire,10,50,85,75,40,260,101
1313034,1313034,Baker Brook,10,35,65,100,55,265,137
1313035,1313035,Baker-Brook,15,90,145,175,140,565,235
1313036,1313036,Lac-Baker,0,0,0,0,0,0,4
1313037,1313037,Lac Baker,15,70,120,275,200,680,505
1313038,1313038,Clair,5,45,75,95,65,285,101
1313039,1313039,Clair,30,115,210,260,165,780,409
1313041,1313041,Saint-François,25,85,145,250,95,600,347
1313042,1313042,Saint-François de Madawaska,15,60,125,175,115,490,265
1314001,1314001,Durham,15,120,200,460,295,1090,592
1314003,1314003,Colborne,5,15,35,100,65,220,144
1314004,1314004,Charlo,45,165,280,470,360,1320,719
1314005,1314005,Balmoral,15,45,80,115,45,300,120
1314006,1314006,Balmoral,60,240,470,530,375,1675,720
1314008,1314008,Dalhousie,35,115,255,420,250,1075,531
1314010,1314010,Eel River 3,35,70,120,80,25,330,146
1314011,1314011,Eel River Crossing,65,305,480,710,385,1945,893
1314012,1314012,Addington,10,90,145,250,155,650,333
1314013,1314013,Atholville,120,460,920,1325,760,3585,1584
1314014,1314014,Campbellton,260,945,1595,2285,1810,6895,3443
1314015,1314015,Tide Head,30,140,235,370,185,960,417
1314016,1314016,Eldon,15,80,145,260,165,665,360
1314017,1314017,Dalhousie,85,300,525,1060,1160,3130,1696
1314020,1314020,Kedgwick,85,285,545,685,365,1965,956
1314021,1314021,Saint-Quentin,70,235,410,580,225,1520,696
1314022,1314022,Saint-Quentin,105,325,590,685,490,2195,989
1314025,1314025,Belledune,35,160,250,545,440,1430,883
1314026,1314026,Indian Ranch,5,25,30,15,10,85,37
1315002,1315002,Tracadie,590,2175,4230,5685,3445,16125,7416
1315006,1315006,Allardville,55,320,510,665,490,2040,932
1315008,1315008,Bathurst,170,655,1200,1765,1005,4795,2292
1315010,1315010,Pabineau 11,5,35,35,40,10,125,62
1315011,1315011,Bathurst,425,1515,2715,3805,3425,11885,6317
1315012,1315012,Beresford,220,870,1635,2335,1190,6250,2780
1315013,1315013,Pointe-Verte,25,80,180,355,240,880,451
1315014,1315014,Petit-Rocher,60,220,435,635,540,1890,896
1315015,1315015,Beresford,145,605,1070,1495,975,4290,2150
1315016,1315016,New Bandon,15,140,210,500,330,1195,794
1315017,1315017,Saint-Léolin,15,65,170,230,165,645,326
1315019,1315019,Paquetville,75,260,595,910,490,2330,1159
1315020,1315020,Paquetville,30,95,195,215,170,705,346
1315021,1315021,Saint-Isidore,40,210,375,505,225,1355,658
1315022,1315022,Saint-Isidore,25,85,195,305,140,750,382
1315024,1315024,Inkerman,95,250,585,850,590,2370,1084
1315026,1315026,Caraquet,45,150,340,520,300,1355,668
1315027,1315027,Bas-Caraquet,30,140,295,505,330,1300,675
1315028,1315028,Caraquet,150,545,1070,1470,1025,4260,2075
1315029,1315029,Shippagan,145,580,1190,1780,1115,4810,2689
1315030,1315030,Le Goulet,20,60,200,310,210,800,321
1315031,1315031,Shippagan,115,340,675,825,630,2585,1225
1315032,1315032,Lamèque,50,150,290,390,410,1290,619
1315033,1315033,Sainte-Marie-Saint-Raphaël,30,90,215,320,210,865,440
1315036,1315036,Bertrand,35,140,260,390,345,1170,678
1315037,1315037,Nigadoo,25,140,240,330,220,955,437
1315038,1315038,Grande-Anse,25,90,165,330,295,905,517
1315040,1315040,Maisonnette,5,40,80,170,185,480,400
2401023,2401023,Les Îles-de-la-Madeleine,405,1445,2780,4465,2925,12020,6223
2401042,2401042,Grosse-Île,10,65,130,175,85,465,254
2402005,2402005,Percé,115,305,675,1130,875,3100,1880
2402010,2402010,Sainte-Thérèse-de-Gaspé,35,100,250,390,235,1010,509
2402015,2402015,Grande-Rivière,115,425,780,1285,800,3405,1701
2402028,2402028,Chandler,235,965,1620,2580,2155,7555,3739
2402047,2402047,Port-Daniel--Gascons,55,275,455,755,665,2205,1140
2402902,2402902,Mont-Alexandre,0,0,0,0,0,0,0
2403005,2403005,Gaspé,635,2045,3725,5050,3110,14565,7074
2403010,2403010,Cloridorme,20,50,105,280,210,665,397
2403015,2403015,Petite-Vallée,0,25,25,65,60,175,91
2403020,2403020,Grande-Vallée,30,125,190,420,295,1060,569
2403025,2403025,Murdochville,25,105,150,210,160,650,512
2403902,2403902,Rivière-Saint-Jean,0,0,0,0,0,0,0
2403904,2403904,Collines-du-Basque,0,0,0,0,0,0,5
2404005,2404005,Sainte-Madeleine-de-la-Rivière-Madeleine,5,25,25,125,120,300,281
2404010,2404010,Saint-Maxime-du-Mont-Louis,50,150,250,390,300,1140,620
2404015,2404015,Mont-Saint-Pierre,5,10,20,60,65,160,139
2404020,2404020,Rivière-à-Claude,5,5,15,50,65,140,123
2404025,2404025,Marsoui,10,25,60,105,80,280,182
2404030,2404030,La Martre,15,25,65,95,55,255,147
2404037,2404037,Sainte-Anne-des-Monts,265,845,1570,2205,1550,6435,3307
2404047,2404047,Cap-Chat,65,295,485,855,780,2480,1333
2404902,2404902,Mont-Albert,10,25,40,75,35,185,150
2404904,2404904,Coulée-des-Adolphe,0,0,0,0,0,0,0
2405010,2405010,Shigawake,15,35,55,90,90,285,171
2405015,2405015,Saint-Godefroi,20,25,70,130,120,365,214
2405020,2405020,Hope Town,15,55,65,115,75,325,170
2405025,2405025,Hope,10,55,105,205,195,570,308
2405032,2405032,Paspébiac,90,360,740,1065,920,3175,1515
2405040,2405040,New Carlisle,40,180,315,435,425,1395,666
2405045,2405045,Bonaventure,110,385,650,860,690,2695,1312
2405050,2405050,Saint-Elzéar,25,55,120,170,105,475,266
2405055,2405055,Saint-Siméon,40,170,290,390,290,1180,590
2405060,2405060,Caplan,95,255,470,670,530,2020,988
2405065,2405065,Saint-Alphonse,40,85,195,250,135,705,330
2405070,2405070,New Richmond,160,540,885,1190,930,3705,1774
2405077,2405077,Cascapédia--Saint-Jules,50,100,190,225,160,725,355
2405902,2405902,Rivière-Bonaventure,0,0,0,0,0,0,85
2406005,2406005,Maria,125,375,625,820,665,2610,1159
2406013,2406013,Carleton-sur-Mer,180,570,1025,1290,1010,4075,2136
2406020,2406020,Nouvelle,80,210,395,555,415,1655,849
2406025,2406025,Escuminac,25,75,145,210,85,540,297
2406030,2406030,Pointe-à-la-Croix,70,200,360,480,285,1395,708
2406035,2406035,Ristigouche-Partie-Sud-Est,5,20,20,60,55,160,91
2406040,2406040,Saint-André-de-Restigouche,5,15,25,70,40,155,95
2406045,2406045,Matapédia,25,85,140,210,200,660,365
2406050,2406050,Saint-Alexis-de-Matapédia,20,50,90,165,175,500,283
2406055,2406055,Saint-François-d'Assise,20,75,120,250,185,650,360
2406060,2406060,L'Ascension-de-Patapédia,5,5,30,60,65,165,113
2406802,2406802,Gesgapegiag,70,155,245,125,60,655,264
2406804,2406804,Listuguj,90,310,360,330,140,1230,620
2406902,2406902,Rivière-Nouvelle,0,0,0,0,0,0,0
2406904,2406904,Ruisseau-Ferguson,0,0,0,0,0,0,0
2407005,2407005,Sainte-Marguerite-Marie,5,20,25,65,50,165,91
2407010,2407010,Sainte-Florence,10,60,65,155,95,385,209
2407018,2407018,Causapscal,75,320,535,785,600,2315,1162
2407025,2407025,Albertville,5,25,50,100,45,225,126
2407030,2407030,Saint-Léon-le-Grand,45,135,225,345,200,950,440
2407035,2407035,Saint-Zénon-du-Lac-Humqui,10,55,80,150,80,375,284
2407040,2407040,Sainte-Irène,15,45,95,120,45,320,259
2407047,2407047,Amqui,295,970,1550,1970,1390,6175,2992
2407057,2407057,Lac-au-Saumon,75,210,335,430,390,1440,598
2407065,2407065,Saint-Alexandre-des-Lacs,15,45,75,125,80,340,172
2407070,2407070,Saint-Tharcisius,10,65,85,95,75,330,144
2407075,2407075,Saint-Vianney,25,75,105,145,110,460,239
2407080,2407080,Val-Brillant,45,140,230,300,215,930,497
2407085,2407085,Sayabec,70,250,400,500,360,1580,763
2407090,2407090,Saint-Cléophas,5,60,70,135,50,320,156
2407095,2407095,Saint-Moïse,30,90,125,190,135,570,292
2407100,2407100,Saint-Noël,20,65,90,135,90,400,212
2407105,2407105,Saint-Damase,20,70,95,150,85,420,210
2407902,2407902,Routhierville,0,0,0,0,0,0,16
2407904,2407904,Rivière-Vaseuse,0,0,0,0,0,0,0
2407906,2407906,Rivière-Patapédia-Est,0,0,0,0,0,0,0
2407908,2407908,Lac-Casault,5,5,15,15,5,45,142
2407910,2407910,Ruisseau-des-Mineurs,0,0,0,0,0,0,36
2407912,2407912,Lac-Alfred,0,0,0,0,0,0,0
2407914,2407914,Lac-Matapédia,10,10,45,65,45,175,102
2408005,2408005,Les Méchins,40,90,195,360,300,985,753
2408010,2408010,Saint-Jean-de-Cherbourg,5,5,10,25,25,70,70
2408015,2408015,Grosses-Roches,10,25,45,110,110,300,230
2408023,2408023,Sainte-Félicité,45,110,225,400,290,1070,635
2408030,2408030,Saint-Adelme,30,110,155,225,170,690,383
2408035,2408035,Saint-René-de-Matane,50,120,245,335,240,990,649
2408040,2408040,Sainte-Paule,15,25,35,85,75,235,209
2408053,2408053,Matane,560,1900,3525,4545,3790,14320,7421
2408065,2408065,Saint-Léandre,25,65,100,125,100,415,209
2408073,2408073,Saint-Ulric,70,210,395,550,360,1585,878
2408080,2408080,Baie-des-Sables,30,110,140,175,180,635,328
2408902,2408902,Rivière-Bonjour,0,0,10,20,10,40,183
2409005,2409005,La Rédemption,15,75,105,130,95,420,251
2409010,2409010,Saint-Charles-Garnier,15,25,35,90,70,235,146
2409015,2409015,Les Hauteurs,25,100,125,140,115,505,263
2409020,2409020,Sainte-Jeanne-d'Arc,10,40,60,115,35,260,169
2409025,2409025,Saint-Gabriel-de-Rimouski,90,200,310,330,225,1155,587
2409030,2409030,Saint-Donat,60,130,240,305,135,870,499
2409035,2409035,Sainte-Angèle-de-Mérici,65,160,250,320,165,960,507
2409040,2409040,Padoue,5,30,60,95,55,245,120
2409048,2409048,Métis-sur-Mer,25,65,130,215,150,585,471
2409055,2409055,Saint-Octave-de-Métis,30,80,135,170,105,520,222
2409060,2409060,Grand-Métis,5,15,25,60,55,160,191
2409065,2409065,Price,130,275,465,525,365,1760,788
2409070,2409070,Saint-Joseph-de-Lepage,40,55,125,170,130,520,258
2409077,2409077,Mont-Joli,300,920,1480,1960,1620,6280,3102
2409085,2409085,Sainte-Flavie,40,135,180,305,225,885,497
2409092,2409092,Sainte-Luce,145,420,710,935,595,2805,1437
2409902,2409902,Lac-des-Eaux-Mortes,0,0,0,0,0,0,184
2409904,2409904,Lac-à-la-Croix,0,0,0,0,0,0,0
2410005,2410005,Esprit-Saint,15,30,80,115,90,330,209
2410010,2410010,La Trinité-des-Monts,10,25,45,85,65,230,173
2410015,2410015,Saint-Narcisse-de-Rimouski,70,130,265,325,160,950,642
2410025,2410025,Saint-Marcellin,15,35,80,140,70,340,324
2410030,2410030,Saint-Anaclet-de-Lessard,180,550,960,905,465,3060,1324
2410043,2410043,Rimouski,2280,6950,13900,14535,10980,48645,24262
2410060,2410060,Saint-Valérien,50,130,230,285,125,820,422
2410070,2410070,Saint-Fabien,90,270,440,590,435,1825,1129
2410075,2410075,Saint-Eugène-de-Ladrière,10,65,95,120,75,365,179
2410902,2410902,Lac-Huron,0,0,0,0,0,0,147
2411005,2411005,Saint-Clément,15,90,130,125,100,460,231
2411010,2411010,Saint-Jean-de-Dieu,95,220,375,505,400,1595,755
2411015,2411015,Sainte-Rita,15,45,60,105,90,315,224
2411020,2411020,Saint-Guy,0,5,0,20,20,45,66
2411025,2411025,Saint-Médard,5,30,25,75,60,195,115
2411030,2411030,Sainte-Françoise,25,45,75,150,105,400,213
2411035,2411035,Saint-Éloi,15,35,60,110,80,300,144
2411040,2411040,Trois-Pistoles,115,370,565,1020,1190,3260,1770
2411045,2411045,Notre-Dame-des-Neiges,35,120,205,400,310,1070,778
2411050,2411050,Saint-Mathieu-de-Rioux,20,75,140,240,175,650,559
2411055,2411055,Saint-Simon,15,50,70,155,135,425,330
2411902,2411902,Lac-Boisbouscache,0,0,0,0,0,0,0
2412005,2412005,Saint-Cyprien,55,170,270,355,215,1065,479
2412010,2412010,Saint-Hubert-de-Rivière-du-Loup,60,185,290,445,305,1285,1010
2412015,2412015,Saint-Antonin,260,780,1285,1140,600,4065,1681
2412020,2412020,Saint-Modeste,95,240,395,295,145,1170,470
2412025,2412025,Saint-François-Xavier-de-Viger,5,45,55,90,40,235,140
2412030,2412030,Saint-Épiphane,65,140,235,230,160,830,393
2412035,2412035,Saint-Paul-de-la-Croix,10,40,70,105,70,295,185
2412043,2412043,L'Isle-Verte,75,175,290,430,320,1290,675
2412045,2412045,Notre-Dame-des-Sept-Douleurs,0,0,0,0,0,0,127
2412057,2412057,Cacouna,105,265,520,545,375,1810,926
2412065,2412065,Saint-Arsène,95,260,350,320,210,1235,468
2412072,2412072,Rivière-du-Loup,875,2740,5480,5710,4705,19510,9772
2412080,2412080,Notre-Dame-du-Portage,30,190,225,400,300,1145,693
2413005,2413005,Dégelis,105,410,625,980,750,2870,1530
2413010,2413010,Saint-Jean-de-la-Lande,5,25,55,90,55,230,167
2413015,2413015,Packington,30,95,150,185,155,615,421
2413020,2413020,Saint-Marc-du-Lac-Long,15,55,80,170,85,405,248
2413025,2413025,Rivière-Bleue,55,150,230,420,360,1215,697
2413030,2413030,Saint-Eusèbe,35,90,150,205,115,595,265
2413040,2413040,Saint-Juste-du-Lac,20,75,140,210,115,560,351
2413045,2413045,Auclair,20,75,120,160,95,470,265
2413050,2413050,Lejeune,5,35,65,95,60,260,176
2413055,2413055,Biencourt,15,60,75,175,155,480,282
2413060,2413060,Lac-des-Aigles,20,80,115,180,115,510,286
2413065,2413065,Saint-Michel-du-Squatec,25,125,185,405,380,1120,570
2413073,2413073,Témiscouata-sur-le-Lac,200,730,1125,1650,1210,4915,2670
2413075,2413075,Saint-Pierre-de-Lamy,5,20,30,40,35,130,106
2413080,2413080,Saint-Louis-du-Ha! Ha!,45,200,285,415,335,1280,591
2413085,2413085,Saint-Elzéar-de-Témiscouata,15,70,95,95,65,340,155
2413090,2413090,Saint-Honoré-de-Témiscouata,40,105,185,230,175,735,365
2413095,2413095,Pohénégamook,105,375,570,865,675,2590,1442
2413100,2413100,Saint-Athanase,10,65,75,110,60,320,191
2414005,2414005,Mont-Carmel,50,125,245,380,325,1125,704
2414010,2414010,Saint-Bruno-de-Kamouraska,20,95,110,185,130,540,285
2414018,2414018,Saint-Pascal,155,500,795,1075,955,3480,1664
2414025,2414025,Sainte-Hélène-de-Kamouraska,55,165,230,285,195,930,400
2414030,2414030,Saint-Joseph-de-Kamouraska,35,85,125,105,50,400,176
2414035,2414035,Saint-Alexandre-de-Kamouraska,140,335,620,580,425,2100,912
2414040,2414040,Saint-André,30,95,165,190,180,660,272
2414045,2414045,Saint-Germain,10,40,85,95,60,290,163
2414050,2414050,Kamouraska,25,80,130,230,145,610,399
2414055,2414055,Saint-Denis-De La Bouteillerie,20,75,110,170,155,530,374
2414060,2414060,Saint-Philippe-de-Néri,35,135,200,250,205,825,388
2414065,2414065,Rivière-Ouelle,50,135,215,315,250,965,635
2414070,2414070,Saint-Pacôme,65,215,380,495,430,1585,715
2414075,2414075,Saint-Gabriel-Lalemant,25,100,160,255,180,720,385
2414080,2414080,Saint-Onésime-d'Ixworth,30,85,150,190,120,575,308
2414085,2414085,La Pocatière,120,695,980,1195,1130,4120,2155
2414090,2414090,Sainte-Anne-de-la-Pocatière,85,255,430,580,280,1630,704
2414902,2414902,Picard,0,0,0,0,0,0,6
2414904,2414904,Petit-Lac-Sainte-Anne,0,0,0,0,0,0,0
2415005,2415005,Saint-Irénée,25,75,110,215,215,640,464
2415013,2415013,La Malbaie,385,1110,1955,2745,2095,8290,4608
2415025,2415025,Notre-Dame-des-Monts,65,115,235,230,140,785,350
2415030,2415030,Saint-Aimé-des-Lacs,55,165,275,345,250,1090,770
2415035,2415035,Clermont,140,455,790,960,755,3100,1481
2415058,2415058,Saint-Siméon,55,140,250,400,385,1230,712
2415065,2415065,Baie-Sainte-Catherine,5,15,45,90,70,225,132
2415902,2415902,Mont-Élie,5,10,0,20,30,65,102
2415904,2415904,Sagard,5,5,35,50,35,130,88
2416005,2416005,Petite-Rivière-Saint-François,35,100,200,270,210,815,797
2416013,2416013,Baie-Saint-Paul,285,935,1620,2320,1995,7155,3674
2416023,2416023,L'Isle-aux-Coudres,25,110,185,375,450,1145,754
2416048,2416048,Les Éboulements,70,165,320,395,380,1330,895
2416050,2416050,Saint-Hilarion,60,170,335,365,215,1145,551
2416055,2416055,Saint-Urbain,75,210,345,425,325,1380,659
2416902,2416902,Lac-Pikauba,0,0,0,0,0,0,0
2417005,2417005,Saint-Omer,10,35,45,105,80,275,216
2417010,2417010,Saint-Pamphile,90,320,515,870,610,2405,1227
2417015,2417015,Saint-Adalbert,30,55,120,190,125,520,328
2417020,2417020,Saint-Marcel,25,50,95,160,110,440,319
2417025,2417025,Sainte-Félicité,10,55,65,145,110,385,206
2417030,2417030,Sainte-Perpétue,75,225,360,555,435,1650,852
2417035,2417035,Tourville,25,85,135,195,150,590,341
2417040,2417040,Saint-Damase-de-L'Islet,15,70,115,220,140,560,324
2417045,2417045,Saint-Cyrille-de-Lessard,35,85,165,245,200,730,606
2417055,2417055,Saint-Aubert,55,240,355,475,355,1480,961
2417060,2417060,Sainte-Louise,40,100,170,220,145,675,331
2417065,2417065,Saint-Roch-des-Aulnaies,40,140,190,305,240,915,569
2417070,2417070,Saint-Jean-Port-Joli,165,465,760,1100,920,3410,1766
2417078,2417078,L'Islet,190,570,935,1240,900,3835,1878
2418005,2418005,Saint-Just-de-Bretenières,30,75,140,260,170,675,400
2418010,2418010,Lac-Frontière,5,20,40,65,60,190,171
2418015,2418015,Saint-Fabien-de-Panet,40,110,205,325,290,970,612
2418020,2418020,Sainte-Lucie-de-Beauregard,10,40,55,110,80,295,202
2418025,2418025,Sainte-Apolline-de-Patton,15,70,115,185,150,535,372
2418030,2418030,Saint-Paul-de-Montminy,25,95,150,280,235,785,503
2418035,2418035,Sainte-Euphémie-sur-Rivière-du-Sud,15,25,65,135,80,320,204
2418040,2418040,Notre-Dame-du-Rosaire,15,50,85,135,100,385,258
2418045,2418045,Cap-Saint-Ignace,135,495,745,960,740,3075,1495
2418050,2418050,Montmagny,415,1545,2735,3525,3050,11270,5651
2418055,2418055,Saint-Pierre-de-la-Rivière-du-Sud,60,150,225,295,180,910,441
2418060,2418060,Saint-François-de-la-Rivière-du-Sud,85,305,465,445,325,1625,724
2418065,2418065,Berthier-sur-Mer,90,200,400,460,405,1555,892
2418070,2418070,Saint-Antoine-de-l'Isle-aux-Grues,5,15,15,45,65,145,154
2419005,2419005,Saint-Philémon,20,65,140,270,205,700,545
2419010,2419010,Notre-Dame-Auxiliatrice-de-Buckland,25,80,160,295,215,775,517
2419015,2419015,Saint-Nazaire-de-Dorchester,15,50,100,135,70,370,183
2419020,2419020,Saint-Léon-de-Standon,50,150,240,380,315,1135,691
2419025,2419025,Saint-Malachie,80,215,390,490,340,1515,798
2419030,2419030,Saint-Damien-de-Buckland,75,265,440,605,585,1970,944
2419037,2419037,Armagh,70,215,340,490,385,1500,808
2419045,2419045,Saint-Nérée-de-Bellechasse,45,80,170,280,175,750,461
2419050,2419050,Saint-Lazare-de-Bellechasse,95,205,380,345,250,1275,562
2419055,2419055,Sainte-Claire,195,495,960,1025,675,3350,1597
2419062,2419062,Saint-Anselme,265,640,1290,1035,700,3930,1669
2419068,2419068,Saint-Henri,470,1020,1940,1325,865,5620,2365
2419070,2419070,Honfleur,65,130,240,250,175,860,358
2419075,2419075,Saint-Gervais,135,425,660,570,370,2160,871
2419082,2419082,Saint-Raphaël,130,405,605,730,530,2400,1212
2419090,2419090,La Durantaye,45,125,220,225,150,765,363
2419097,2419097,Saint-Charles-de-Bellechasse,190,390,730,680,395,2385,1022
2419105,2419105,Beaumont,215,465,800,750,735,2965,1328
2419110,2419110,Saint-Michel-de-Bellechasse,95,290,440,545,440,1810,928
2419117,2419117,Saint-Vallier,40,190,260,325,240,1055,518
2420005,2420005,Saint-François-de-l'Île-d'Orléans,20,70,95,195,145,525,384
2420010,2420010,Sainte-Famille,35,135,185,305,270,930,445
2420015,2420015,Saint-Jean-de-l'Île-d'Orléans,45,105,245,380,270,1045,681
2420020,2420020,Saint-Laurent-de-l'Île-d'Orléans,80,210,370,495,375,1530,827
2420025,2420025,Saint-Pierre-de-l'Île-d'Orléans,80,315,500,595,505,1995,871
2420030,2420030,Sainte-Pétronille,40,160,220,330,290,1040,495
2421005,2421005,Saint-Tite-des-Caps,70,190,365,520,325,1470,866
2421010,2421010,Saint-Ferréol-les-Neiges,160,480,825,1140,615,3220,2382
2421015,2421015,Saint-Louis-de-Gonzague-du-Cap-Tourmente,0,0,0,0,0,0,1
2421020,2421020,Saint-Joachim,75,220,360,455,330,1440,677
2421025,2421025,Beaupré,165,480,880,1215,1015,3755,2468
2421030,2421030,Sainte-Anne-de-Beaupré,135,375,700,905,775,2890,1452
2421035,2421035,Château-Richer,305,560,1235,1210,825,4135,1905
2421040,2421040,L'Ange-Gardien,205,610,1175,1125,575,3690,1625
2421045,2421045,Boischatel,555,1485,2480,2020,1055,7595,2868
2421902,2421902,Sault-au-Cochon,0,0,0,0,0,0,0
2421904,2421904,Lac-Jacques-Cartier,0,0,0,0,0,0,0
2422005,2422005,Sainte-Catherine-de-la-Jacques-Cartier,785,1360,2935,1820,795,7695,3063
2422010,2422010,Fossambault-sur-le-Lac,175,285,585,620,310,1975,1283
2422015,2422015,Lac-Saint-Joseph,0,20,25,125,80,250,358
2422020,2422020,Shannon,610,1405,2520,1195,295,6025,2277
2422025,2422025,Saint-Gabriel-de-Valcartier,310,675,1410,730,265,3390,1204
2422030,2422030,Lac-Delage,50,150,185,190,55,630,254
2422035,2422035,Stoneham-et-Tewkesbury,655,1610,2895,2335,855,8350,3924
2422040,2422040,Lac-Beauport,445,1840,2210,2485,815,7795,3031
2422045,2422045,Sainte-Brigitte-de-Laval,880,1275,3005,1575,600,7335,3007
2422902,2422902,Lac-Croche,0,0,0,0,0,0,0
2423015,2423015,Notre-Dame-des-Anges,0,0,0,5,305,310,0
2423027,2423027,Québec,26435,72630,176890,146380,109565,531900,266409
2423057,2423057,L'Ancienne-Lorette,680,2795,4555,5140,3375,16545,7120
2423072,2423072,Saint-Augustin-de-Desmaures,785,3575,4930,6505,3015,18810,7678
2423802,2423802,Wendake,95,385,635,680,340,2135,973
2425213,2425213,Lévis,7870,24700,44045,41665,25135,143415,62585
2426005,2426005,Frampton,55,200,295,420,250,1220,544
2426010,2426010,Saints-Anges,90,195,375,320,185,1165,485
2426015,2426015,Vallée-Jonction,100,290,545,565,375,1875,866
2426022,2426022,Saint-Elzéar,195,490,840,580,290,2395,949
2426030,2426030,Sainte-Marie,795,2285,4180,3795,2510,13565,5857
2426035,2426035,Sainte-Marguerite,70,210,325,300,190,1095,451
2426040,2426040,Sainte-Hénédine,105,220,360,315,270,1270,483
2426048,2426048,Scott,220,395,825,605,295,2340,1046
2426055,2426055,Saint-Bernard,190,420,780,620,310,2320,974
2426063,2426063,Saint-Isidore,200,505,900,780,500,2885,1220
2426070,2426070,Saint-Lambert-de-Lauzon,540,1320,2175,1770,835,6640,2626
2427008,2427008,Saint-Victor,100,465,630,695,560,2450,1222
2427015,2427015,Saint-Alfred,30,110,135,140,85,500,249
2427028,2427028,Beauceville,340,1040,1765,1760,1400,6305,2834
2427035,2427035,Saint-Odilon-de-Cranbourne,80,245,385,405,260,1375,585
2427043,2427043,Saint-Joseph-de-Beauce,315,855,1385,1335,975,4865,2133
2427050,2427050,Saint-Joseph-des-Érables,30,80,115,115,65,405,163
2427055,2427055,Saint-Jules,40,100,135,145,120,540,241
2427060,2427060,Tring-Jonction,75,260,400,390,285,1410,604
2427065,2427065,Saint-Frédéric,70,180,295,300,185,1030,479
2427070,2427070,Saint-Séverin,25,40,55,90,70,280,188
2428005,2428005,Saint-Zacharie,95,240,375,620,325,1655,791
2428015,2428015,Sainte-Aurélie,50,120,195,320,165,850,483
2428020,2428020,Saint-Prosper,200,565,1040,1025,770,3600,1600
2428025,2428025,Saint-Benjamin,80,165,300,280,155,980,461
2428030,2428030,Sainte-Rose-de-Watford,30,110,195,250,150,735,469
2428035,2428035,Saint-Louis-de-Gonzague,15,55,70,145,85,370,232
2428040,2428040,Saint-Cyprien,15,65,100,185,125,490,308
2428045,2428045,Sainte-Justine,80,330,480,530,415,1835,850
2428053,2428053,Lac-Etchemin,130,540,810,1185,1155,3820,2076
2428060,2428060,Saint-Luc-de-Bellechasse,10,60,65,160,135,430,347
2428065,2428065,Sainte-Sabine,5,35,55,135,140,370,230
2428070,2428070,Saint-Camille-de-Lellis,15,95,150,290,195,745,467
2428075,2428075,Saint-Magloire,25,85,125,225,225,685,450
2429005,2429005,Saint-Théophile,40,135,170,260,125,730,357
2429013,2429013,Saint-Gédéon-de-Beauce,140,360,670,610,420,2200,953
2429020,2429020,Saint-Hilaire-de-Dorset,5,10,15,35,20,85,49
2429025,2429025,Saint-Évariste-de-Forsyth,30,80,155,180,95,540,320
2429030,2429030,La Guadeloupe,95,265,485,500,365,1710,800
2429038,2429038,Saint-Honoré-de-Shenley,95,305,410,385,295,1490,629
2429045,2429045,Saint-Martin,145,415,740,745,435,2480,1189
2429050,2429050,Saint-René,60,145,260,185,75,725,321
2429057,2429057,Saint-Côme--Linière,235,565,975,965,505,3245,1517
2429065,2429065,Saint-Philibert,20,80,100,105,60,365,156
2429073,2429073,Saint-Georges,1825,5365,9415,9540,6360,32505,15022
2429095,2429095,Lac-Poulin,10,20,35,60,25,150,154
2429100,2429100,Saint-Benoît-Labre,105,270,500,515,245,1635,797
2429112,2429112,Saint-Éphrem-de-Beauce,125,425,710,720,410,2390,1044
2429120,2429120,Notre-Dame-des-Pins,100,240,465,440,340,1585,650
2429125,2429125,Saint-Simon-les-Mines,30,120,155,170,70,545,237
2430005,2430005,Saint-Augustin-de-Woburn,45,115,170,240,115,685,344
2430010,2430010,Notre-Dame-des-Bois,55,165,195,300,225,940,906
2430015,2430015,Val-Racine,5,40,45,65,25,180,126
2430020,2430020,Piopolis,0,30,55,130,130,345,304
2430025,2430025,Frontenac,100,325,455,535,330,1745,870
2430030,2430030,Lac-Mégantic,225,915,1325,1725,1470,5660,2870
2430035,2430035,Marston,40,110,205,220,125,700,401
2430040,2430040,Milan,15,40,65,125,65,310,228
2430045,2430045,Nantes,50,250,380,470,225,1375,696
2430050,2430050,Sainte-Cécile-de-Whitton,55,160,230,240,185,870,513
2430055,2430055,Audet,50,130,190,225,135,730,303
2430070,2430070,Saint-Robert-Bellarmin,25,95,165,210,65,560,231
2430072,2430072,Saint-Ludger,55,170,255,350,245,1075,529
2430080,2430080,Lac-Drolet,40,145,235,385,235,1040,618
2430085,2430085,Saint-Sébastien,45,70,165,260,120,660,343
2430090,2430090,Courcelles,35,120,185,275,215,830,434
2430095,2430095,Lambton,70,265,325,495,445,1600,1200
2430100,2430100,Saint-Romain,30,115,170,240,130,685,405
2430105,2430105,Stornoway,30,80,140,165,125,540,262
2430110,2430110,Stratford,35,90,145,375,315,960,895
2431008,2431008,Beaulac-Garthby,15,100,140,330,335,920,839
2431015,2431015,Disraeli,90,290,555,710,700,2345,1288
2431020,2431020,Disraeli,40,140,250,430,270,1130,760
2431025,2431025,Saint-Jacques-le-Majeur-de-Wolfestown,5,35,35,60,40,175,127
2431030,2431030,Saint-Fortunat,10,30,65,110,55,270,176
2431035,2431035,Saint-Julien,15,50,90,130,80,365,197
2431040,2431040,Irlande,35,135,200,340,170,880,434
2431045,2431045,Saint-Joseph-de-Coleraine,55,260,400,585,475,1775,1115
2431050,2431050,Sainte-Praxède,10,45,60,100,90,305,298
2431056,2431056,Adstock,155,420,700,930,595,2800,1803
2431060,2431060,Sainte-Clotilde-de-Beauce,30,90,160,150,130,560,278
2431084,2431084,Thetford Mines,1095,3380,6155,7495,7280,25405,12691
2431095,2431095,Saint-Adrien-d'Irlande,20,60,80,155,75,390,209
2431100,2431100,Saint-Jean-de-Brébeuf,30,60,110,105,85,390,185
2431105,2431105,Kinnear's Mills,25,40,100,105,70,340,188
2431122,2431122,East Broughton,105,315,580,650,555,2205,1038
2431130,2431130,Sacré-Coeur-de-Jésus,20,95,135,160,90,500,267
2431135,2431135,Saint-Pierre-de-Broughton,55,160,230,250,210,905,473
2431140,2431140,Saint-Jacques-de-Leeds,55,110,175,200,155,695,348
2432013,2432013,Saint-Ferdinand,80,255,475,685,595,2090,1278
2432023,2432023,Sainte-Sophie-d'Halifax,35,125,135,210,100,605,256
2432033,2432033,Princeville,400,1080,1795,1665,1050,5990,2702
2432040,2432040,Plessisville,270,1000,1640,1825,1805,6540,3202
2432045,2432045,Plessisville,175,475,725,825,470,2670,1106
2432050,2432050,Saint-Pierre-Baptiste,35,80,140,190,75,520,273
2432058,2432058,Inverness,55,165,215,275,190,900,518
2432065,2432065,Lyster,95,260,400,460,385,1600,752
2432072,2432072,Laurierville,75,225,370,415,250,1335,634
2432080,2432080,Notre-Dame-de-Lourdes,45,105,170,240,120,680,354
2432085,2432085,Villeroy,20,70,100,125,130,445,240
2433007,2433007,Saint-Sylvestre,45,180,260,325,215,1025,453
2433017,2433017,Sainte-Agathe-de-Lotbinière,50,190,305,355,260,1160,536
2433025,2433025,Saint-Patrice-de-Beaurivage,55,185,310,315,175,1040,460
2433030,2433030,Saint-Narcisse-de-Beaurivage,85,220,355,290,155,1105,447
2433035,2433035,Saint-Gilles,215,420,840,625,425,2525,1113
2433040,2433040,Dosquet,50,155,290,290,150,935,438
2433045,2433045,Saint-Agapit,360,710,1490,1050,660,4270,1842
2433052,2433052,Saint-Flavien,95,275,480,475,305,1630,720
2433060,2433060,Laurier-Station,135,440,755,755,480,2565,1111
2433065,2433065,Saint-Janvier-de-Joly,65,135,275,320,175,970,467
2433070,2433070,Val-Alain,50,150,260,315,155,930,427
2433080,2433080,Saint-Édouard-de-Lotbinière,85,205,325,355,235,1205,547
2433085,2433085,Notre-Dame-du-Sacré-Coeur-d'Issoudun,55,175,260,270,100,860,355
2433090,2433090,Saint-Apollinaire,440,940,2220,1685,820,6105,2818
2433095,2433095,Saint-Antoine-de-Tilly,80,280,365,500,370,1595,824
2433102,2433102,Sainte-Croix,125,345,620,785,650,2525,1274
2433115,2433115,Lotbinière,30,80,165,270,275,820,548
2433123,2433123,Leclercville,35,50,105,140,125,455,262
2434007,2434007,Neuville,310,710,1285,1395,690,4390,1898
2434017,2434017,Pont-Rouge,645,1655,2995,2555,1400,9250,3939
2434025,2434025,Donnacona,445,920,2195,1995,1635,7190,3180
2434030,2434030,Cap-Santé,255,500,970,1040,645,3410,1529
2434038,2434038,Saint-Basile,155,385,710,830,550,2630,1293
2434048,2434048,Portneuf,160,405,825,1045,750,3185,1658
2434058,2434058,Deschambault-Grondines,125,320,600,750,430,2225,1137
2434060,2434060,Saint-Gilbert,10,55,80,90,55,290,123
2434065,2434065,Saint-Marc-des-Carrières,145,365,705,920,785,2920,1361
2434078,2434078,Saint-Casimir,65,160,315,465,425,1430,755
2434085,2434085,Saint-Thuribe,15,40,80,100,60,295,172
2434090,2434090,Saint-Ubalde,60,185,295,485,385,1410,1047
2434097,2434097,Saint-Alban,55,160,285,390,300,1190,737
2434105,2434105,Sainte-Christine-d'Auvergne,20,95,175,240,170,700,502
2434115,2434115,Saint-Léonard-de-Portneuf,70,185,305,380,225,1165,673
2434120,2434120,Lac-Sergent,30,55,130,190,100,505,457
2434128,2434128,Saint-Raymond,525,1475,2770,3155,2305,10230,5475
2434135,2434135,Rivière-à-Pierre,15,70,105,210,190,590,605
2434902,2434902,Lac-Blanc,0,0,0,0,0,0,0
2434904,2434904,Linton,0,0,0,0,0,0,45
2434906,2434906,Lac-Lapeyrère,0,0,0,0,0,0,0
2435005,2435005,Notre-Dame-de-Montauban,15,50,100,335,240,740,745
2435010,2435010,Lac-aux-Sables,40,130,195,490,435,1290,1133
2435015,2435015,Saint-Adelphe,30,115,195,295,300,935,596
2435020,2435020,Saint-Séverin,30,145,220,265,175,835,409
2435027,2435027,Saint-Tite,135,455,755,1150,1170,3665,2182
2435035,2435035,Hérouxville,55,195,325,475,240,1290,654
2435040,2435040,Grandes-Piles,15,45,80,175,115,430,275
2435045,2435045,Saint-Roch-de-Mékinac,5,25,55,130,90,305,293
2435050,2435050,Sainte-Thècle,110,320,500,780,800,2510,1432
2435055,2435055,Trois-Rives,10,20,60,165,140,395,480
2435902,2435902,Lac-Masketsi,0,0,0,0,0,0,0
2435904,2435904,Lac-Normand,0,0,0,0,0,0,38
2435906,2435906,Rivière-de-la-Savane,0,0,0,0,0,0,86
2435908,2435908,Lac-Boulé,0,0,0,0,0,0,1
2436033,2436033,Shawinigan,2030,5995,11805,16035,13475,49340,26953
2437067,2437067,Trois-Rivières,6015,19220,39010,39495,30670,134410,67771
2437205,2437205,Sainte-Anne-de-la-Pérade,90,280,435,660,545,2010,1156
2437210,2437210,Batiscan,35,105,175,335,255,905,517
2437215,2437215,Sainte-Geneviève-de-Batiscan,25,115,210,380,250,980,608
2437220,2437220,Champlain,85,210,430,605,410,1740,927
2437225,2437225,Saint-Luc-de-Vincennes,25,60,155,170,125,535,278
2437230,2437230,Saint-Maurice,290,570,1085,910,440,3295,1345
2437235,2437235,Notre-Dame-du-Mont-Carmel,345,980,1695,1860,875,5755,2518
2437240,2437240,Saint-Narcisse,105,270,445,545,460,1825,880
2437245,2437245,Saint-Stanislas,35,105,215,385,270,1010,592
2437250,2437250,Saint-Prosper-de-Champlain,30,55,115,195,125,520,267
2438005,2438005,Saint-Sylvère,30,135,205,270,150,790,391
2438010,2438010,Bécancour,790,2025,3825,3780,2600,13020,6031
2438015,2438015,Sainte-Marie-de-Blandford,30,50,110,175,105,470,299
2438020,2438020,Lemieux,10,55,70,110,60,305,136
2438028,2438028,Manseau,45,120,185,270,200,820,435
2438035,2438035,Sainte-Françoise,15,60,105,150,115,445,242
2438040,2438040,Sainte-Sophie-de-Lévrard,35,100,160,225,215,735,412
2438047,2438047,Fortierville,40,105,135,200,185,665,304
2438055,2438055,Parisville,25,85,120,155,125,510,257
2438060,2438060,Sainte-Cécile-de-Lévrard,25,65,100,120,70,380,167
2438065,2438065,Saint-Pierre-les-Becquets,40,145,195,395,355,1130,619
2438070,2438070,Deschaillons-sur-Saint-Laurent,35,90,175,340,255,895,557
2438802,2438802,Wôlinak,15,40,70,45,20,190,97
2439005,2439005,Saints-Martyrs-Canadiens,5,10,45,120,70,250,254
2439010,2439010,Ham-Nord,35,145,195,260,240,875,437
2439015,2439015,Notre-Dame-de-Ham,15,70,95,145,85,410,236
2439020,2439020,Saint-Rémi-de-Tingwick,25,60,110,160,100,455,285
2439025,2439025,Tingwick,90,215,390,470,255,1420,748
2439030,2439030,Chesterville,65,160,270,285,135,915,416
2439035,2439035,Sainte-Hélène-de-Chester,30,60,115,105,65,375,197
2439043,2439043,Saint-Norbert-d'Arthabaska,80,200,335,355,185,1155,501
2439060,2439060,Saint-Christophe-d'Arthabaska,205,650,940,865,370,3030,1173
2439062,2439062,Victoriaville,2325,7365,12780,12845,10805,46120,21380
2439077,2439077,Warwick,240,785,1310,1365,925,4625,2049
2439085,2439085,Saint-Albert,110,300,515,470,205,1600,677
2439090,2439090,Sainte-Élizabeth-de-Warwick,25,75,120,100,55,375,152
2439097,2439097,Kingsey Falls,95,410,590,635,215,1945,813
2439105,2439105,Sainte-Séraphine,15,70,115,100,45,345,205
2439117,2439117,Sainte-Clotilde-de-Horton,90,265,445,475,275,1550,852
2439130,2439130,Saint-Samuel,35,135,230,230,125,755,354
2439135,2439135,Saint-Valère,55,250,385,400,165,1255,523
2439145,2439145,Saint-Rosaire,70,140,270,215,145,840,367
2439150,2439150,Sainte-Anne-du-Sault,70,225,355,385,255,1290,589
2439155,2439155,Daveluyville,45,160,245,295,205,950,508
2439165,2439165,Maddington Falls,15,55,100,160,100,430,226
2439170,2439170,Saint-Louis-de-Blandford,70,135,330,325,145,1005,541
2440005,2440005,Ham-Sud,5,40,40,85,55,225,141
2440010,2440010,Saint-Adrien,35,85,130,150,130,530,253
2440017,2440017,Wotton,80,250,345,460,295,1430,692
2440025,2440025,Saint-Camille,45,105,155,125,90,520,255
2440032,2440032,Saint-Georges-de-Windsor,65,155,275,300,160,955,490
2440043,2440043,Asbestos,290,985,1435,1950,2120,6780,3503
2440047,2440047,Danville,165,605,875,1240,930,3815,1892
2441012,2441012,Saint-Isidore-de-Clifton,35,95,165,245,160,700,371
2441020,2441020,Chartierville,5,15,45,120,90,275,222
2441027,2441027,La Patrie,40,115,165,295,155,770,433
2441037,2441037,Newport,20,145,160,250,160,735,382
2441038,2441038,Cookshire-Eaton,325,1015,1510,1540,1020,5410,2275
2441055,2441055,Ascot Corner,240,645,995,905,365,3150,1235
2441060,2441060,East Angus,230,610,1045,985,790,3660,1644
2441065,2441065,Westbury,70,150,300,315,170,1005,428
2441070,2441070,Bury,75,185,305,350,255,1170,613
2441075,2441075,Hampden,5,30,40,70,25,170,104
2441080,2441080,Scotstown,20,60,110,170,120,480,279
2441085,2441085,Lingwick,10,65,90,145,115,425,344
2441098,2441098,Weedon,110,340,525,950,745,2670,1754
2441117,2441117,Dudswell,75,265,405,590,385,1720,1119
2442005,2442005,Stoke,155,535,855,940,455,2940,1258
2442020,2442020,Saint-François-Xavier-de-Brompton,155,370,705,685,370,2285,967
2442025,2442025,Saint-Denis-de-Brompton,320,740,1210,1185,585,4040,1881
2442032,2442032,Racine,60,225,320,445,280,1330,695
2442040,2442040,Bonsecours,40,80,150,195,130,595,319
2442045,2442045,Lawrenceville,35,130,180,195,100,640,293
2442050,2442050,Sainte-Anne-de-la-Rochelle,30,110,155,195,90,580,275
2442055,2442055,Valcourt,100,350,560,640,495,2145,1103
2442060,2442060,Valcourt,50,175,270,320,225,1040,492
2442065,2442065,Maricourt,10,85,95,130,105,425,192
2442070,2442070,Kingsbury,5,30,40,55,15,145,68
2442075,2442075,Melbourne,60,175,255,360,205,1055,504
2442078,2442078,Ulverton,20,70,105,130,80,405,218
2442088,2442088,Windsor,335,905,1565,1505,1120,5430,2422
2442095,2442095,Val-Joli,115,270,475,515,235,1610,696
2442098,2442098,Richmond,170,415,900,960,785,3230,1679
2442100,2442100,Saint-Claude,90,195,340,415,155,1195,603
2442110,2442110,Cleveland,65,215,355,460,450,1545,694
2443027,2443027,Sherbrooke,8650,26525,53795,42200,30155,161325,80341
2444003,2444003,Saint-Malo,30,90,130,160,75,485,282
2444005,2444005,Saint-Venant-de-Paquette,0,20,10,30,25,85,87
2444010,2444010,East Hereford,15,45,75,80,40,255,145
2444015,2444015,Saint-Herménégilde,30,100,175,200,175,680,554
2444023,2444023,Dixville,45,165,200,195,95,700,299
2444037,2444037,Coaticook,425,1470,2315,2455,2025,8690,3956
2444045,2444045,Barnston-Ouest,50,145,210,255,175,835,494
2444050,2444050,Stanstead-Est,20,95,120,210,145,590,326
2444055,2444055,Sainte-Edwidge-de-Clifton,45,115,160,120,60,500,190
2444060,2444060,Martinville,15,95,110,145,80,445,187
2444071,2444071,Compton,215,565,935,870,550,3135,1342
2444080,2444080,Waterville,115,475,595,580,365,2130,885
2445008,2445008,Stanstead,145,505,685,795,660,2790,1358
2445020,2445020,Ogden,20,125,150,225,220,740,545
2445025,2445025,Stanstead,25,115,165,385,345,1035,861
2445030,2445030,Potton,55,220,340,615,625,1855,2068
2445035,2445035,Ayer's Cliff,60,175,245,315,245,1040,619
2445043,2445043,Hatley,30,110,155,230,165,690,469
2445050,2445050,North Hatley,30,70,140,185,205,630,448
2445055,2445055,Hatley,90,400,495,735,390,2110,928
2445060,2445060,Sainte-Catherine-de-Hatley,90,405,565,855,545,2460,1344
2445072,2445072,Magog,1135,3840,6435,8160,7095,26665,14277
2445080,2445080,Saint-Benoît-du-Lac,0,0,0,0,0,0,0
2445085,2445085,Austin,45,170,255,605,415,1490,1414
2445093,2445093,Eastman,70,220,325,685,555,1855,1414
2445095,2445095,Bolton-Est,35,100,170,370,240,915,810
2445100,2445100,Saint-Étienne-de-Bolton,15,65,100,290,205,675,516
2445105,2445105,Stukely-Sud,40,170,260,365,240,1075,568
2445115,2445115,Orford,230,625,1055,1600,815,4325,2791
2446005,2446005,Abercorn,10,45,55,100,120,330,236
2446010,2446010,Frelighsburg,30,150,210,415,310,1115,624
2446017,2446017,Saint-Armand,55,155,260,425,320,1215,656
2446025,2446025,Pike River,30,70,135,180,100,515,275
2446030,2446030,Stanbridge Station,10,45,70,105,50,280,132
2446035,2446035,Bedford,110,390,640,715,705,2560,1281
2446040,2446040,Bedford,35,95,145,230,160,665,286
2446045,2446045,Stanbridge East,35,150,220,290,175,870,388
2446050,2446050,Dunham,155,595,830,1140,705,3425,1717
2446058,2446058,Sutton,110,445,695,1425,1330,4005,3670
2446065,2446065,Bolton-Ouest,25,50,110,250,210,645,504
2446070,2446070,Brome,20,30,70,125,60,305,145
2446075,2446075,Lac-Brome,205,690,1080,1815,1715,5505,3560
2446078,2446078,Bromont,485,1625,2490,2775,1675,9050,5198
2446080,2446080,Cowansville,670,2120,3860,3960,3055,13665,6272
2446085,2446085,East Farnham,35,75,150,205,95,560,239
2446090,2446090,Brigham,90,425,610,785,395,2305,1082
2446095,2446095,Saint-Ignace-de-Stanbridge,25,130,195,220,115,685,283
2446100,2446100,Notre-Dame-de-Stanbridge,40,115,180,210,140,685,292
2446105,2446105,Sainte-Sabine,60,215,335,335,140,1085,443
2446112,2446112,Farnham,565,1530,2610,2500,1715,8920,4187
2447010,2447010,Saint-Alphonse-de-Granby,235,625,1020,945,270,3095,1160
2447017,2447017,Granby,3405,10440,18505,19550,14330,66230,30880
2447025,2447025,Waterloo,255,785,1155,1280,930,4405,2124
2447030,2447030,Warden,25,50,95,130,65,365,165
2447035,2447035,Shefford,355,1280,1890,2395,1025,6945,2903
2447040,2447040,Saint-Joachim-de-Shefford,90,240,355,420,175,1280,582
2447047,2447047,Roxton Pond,220,700,1095,1205,575,3795,1701
2447055,2447055,Sainte-Cécile-de-Milton,170,420,690,630,240,2150,849
2448005,2448005,Béthanie,15,50,85,120,55,325,153
2448010,2448010,Roxton Falls,80,235,350,400,235,1300,613
2448015,2448015,Roxton,50,195,265,325,240,1075,494
2448020,2448020,Sainte-Christine,35,135,180,240,135,725,334
2448028,2448028,Acton Vale,335,1285,1980,2305,1735,7640,3594
2448038,2448038,Upton,140,345,635,605,375,2100,912
2448045,2448045,Saint-Théodore-d'Acton,100,295,440,445,240,1520,630
2448050,2448050,Saint-Nazaire-d'Acton,55,160,270,275,130,890,371
2449005,2449005,Saint-Félix-de-Kingsey,85,215,380,460,290,1430,741
2449015,2449015,Durham-Sud,55,215,300,295,185,1050,467
2449020,2449020,Lefebvre,55,180,285,280,110,910,395
2449025,2449025,L'Avenir,55,210,320,465,265,1315,640
2449030,2449030,Saint-Lucien,75,245,475,580,275,1650,947
2449040,2449040,Wickham,150,530,785,740,330,2535,1030
2449048,2449048,Saint-Germain-de-Grantham,355,1030,1660,1270,625,4940,1978
2449058,2449058,Drummondville,3905,12260,22440,21365,15450,75420,35402
2449070,2449070,Saint-Cyrille-de-Wendover,345,1015,1530,1235,610,4735,1838
2449075,2449075,Notre-Dame-du-Bon-Conseil,100,250,450,395,370,1565,675
2449080,2449080,Notre-Dame-du-Bon-Conseil,45,155,235,345,160,940,442
2449085,2449085,Sainte-Brigitte-des-Saults,55,100,210,245,105,715,325
2449095,2449095,Saint-Majorique-de-Grantham,95,340,430,340,180,1385,514
2449100,2449100,Saint-Edmond-de-Grantham,65,160,235,195,115,770,306
2449105,2449105,Saint-Eugène,55,195,325,340,205,1120,512
2449113,2449113,Saint-Guillaume,105,260,425,435,270,1495,687
2449125,2449125,Saint-Bonaventure,70,195,325,305,155,1050,467
2449130,2449130,Saint-Pie-de-Guire,25,80,110,140,85,440,215
2450005,2450005,Sainte-Eulalie,70,140,275,250,175,910,425
2450013,2450013,Aston-Jonction,35,95,135,90,70,425,174
2450023,2450023,Saint-Wenceslas,95,180,335,350,195,1155,530
2450030,2450030,Saint-Célestin,40,115,260,225,180,820,385
2450035,2450035,Saint-Célestin,40,95,170,180,95,580,254
2450042,2450042,Saint-Léonard-d'Aston,140,420,655,690,430,2335,1075
2450050,2450050,Sainte-Perpétue,45,185,245,295,180,950,400
2450057,2450057,Sainte-Monique,30,95,140,150,80,495,228
2450065,2450065,Grand-Saint-Esprit,35,80,155,155,75,500,207
2450072,2450072,Nicolet,405,1130,2055,2430,2160,8180,3751
2450085,2450085,La Visitation-de-Yamaska,20,55,85,105,40,305,151
2450090,2450090,Saint-Zéphirin-de-Courval,35,135,215,185,120,690,315
2450095,2450095,Saint-Elphège,20,50,65,85,40,260,112
2450100,2450100,Baie-du-Febvre,55,145,255,345,195,995,522
2450113,2450113,Pierreville,85,295,510,710,550,2150,1185
2450128,2450128,Saint-François-du-Lac,85,255,445,655,525,1965,1101
2450802,2450802,Odanak,20,75,145,140,65,445,230
2451008,2451008,Maskinongé,110,305,635,735,540,2325,1127
2451015,2451015,Louiseville,255,745,1480,2420,2260,7160,3704
2451020,2451020,Yamachiche,165,460,820,875,510,2830,1285
2451025,2451025,Saint-Barnabé,70,155,350,410,210,1195,565
2451030,2451030,Saint-Sévère,20,45,85,90,70,310,150
2451035,2451035,Saint-Léon-le-Grand,35,145,245,325,180,930,406
2451040,2451040,Sainte-Ursule,45,180,310,470,320,1325,705
2451045,2451045,Saint-Justin,30,120,200,390,235,975,524
2451050,2451050,Saint-Édouard-de-Maskinongé,25,100,160,265,155,705,380
2451055,2451055,Sainte-Angèle-de-Prémont,15,55,125,230,155,580,351
2451060,2451060,Saint-Paulin,65,220,350,535,315,1485,765
2451065,2451065,Saint-Alexis-des-Monts,95,315,570,1135,860,2975,2149
2451070,2451070,Saint-Mathieu-du-Parc,30,175,280,505,345,1335,1193
2451075,2451075,Saint-Élie-de-Caxton,80,240,435,665,420,1840,1224
2451080,2451080,Charette,55,110,255,335,195,950,493
2451085,2451085,Saint-Boniface,370,850,1445,1365,805,4835,2117
2451090,2451090,Saint-Étienne-des-Grès,350,750,1435,1310,705,4550,1937
2452007,2452007,Lavaltrie,890,2560,4410,3930,1870,13660,5507
2452017,2452017,Lanoraie,285,725,1345,1495,935,4785,2059
2452030,2452030,Sainte-Élisabeth,80,225,395,470,285,1455,637
2452035,2452035,Berthierville,175,515,1090,1270,1135,4185,2126
2452040,2452040,Sainte-Geneviève-de-Berthier,105,345,645,790,390,2275,981
2452045,2452045,Saint-Ignace-de-Loyola,80,290,490,690,510,2060,960
2452050,2452050,La Visitation-de-l'Île-Dupas,15,95,130,220,165,625,320
2452055,2452055,Saint-Barthélemy,85,255,495,655,435,1925,1053
2452062,2452062,Saint-Cuthbert,85,290,460,630,415,1880,944
2452070,2452070,Saint-Norbert,65,130,290,360,170,1015,479
2452075,2452075,Saint-Cléophas-de-Brandon,10,35,55,75,40,215,96
2452080,2452080,Saint-Gabriel,110,320,565,850,805,2650,1515
2452085,2452085,Saint-Gabriel-de-Brandon,105,325,590,955,670,2645,1632
2452090,2452090,Saint-Didace,25,75,130,230,185,645,548
2452095,2452095,Mandeville,65,245,410,855,625,2200,1911
2453005,2453005,Saint-David,45,135,220,265,175,840,389
2453010,2453010,Massueville,30,90,135,180,75,510,266
2453015,2453015,Saint-Aimé,25,70,135,155,80,465,210
2453020,2453020,Saint-Robert,70,265,505,655,295,1790,798
2453025,2453025,Sainte-Victoire-de-Sorel,105,390,655,870,440,2460,1127
2453032,2453032,Saint-Ours,60,215,415,595,375,1660,871
2453040,2453040,Saint-Roch-de-Richelieu,115,380,660,690,340,2185,997
2453050,2453050,Saint-Joseph-de-Sorel,70,240,435,545,345,1635,931
2453052,2453052,Sorel-Tracy,1440,4215,8655,10780,9645,34735,17368
2453065,2453065,Sainte-Anne-de-Sorel,95,395,665,960,650,2765,1430
2453072,2453072,Yamaska,80,260,440,535,380,1695,938
2453085,2453085,Saint-Gérard-Majella,20,40,45,90,55,250,100
2454008,2454008,Saint-Pie,390,1025,1775,1685,730,5605,2475
2454017,2454017,Saint-Damase,135,420,730,775,400,2460,1043
2454025,2454025,Sainte-Madeleine,125,405,755,675,265,2225,973
2454030,2454030,Sainte-Marie-Madeleine,170,560,870,900,385,2885,1167
2454035,2454035,La Présentation,180,515,835,715,305,2550,1048
2454048,2454048,Saint-Hyacinthe,2615,8130,15915,15775,13215,55650,27050
2454060,2454060,Saint-Dominique,185,535,870,660,310,2560,1009
2454065,2454065,Saint-Valérien-de-Milton,115,355,555,510,260,1795,788
2454072,2454072,Saint-Liboire,235,655,990,880,300,3060,1145
2454090,2454090,Saint-Simon,125,270,455,395,175,1420,546
2454095,2454095,Sainte-Hélène-de-Bagot,135,340,540,465,205,1685,720
2454100,2454100,Saint-Hugues,115,250,390,385,190,1330,572
2454105,2454105,Saint-Barnabé-Sud,70,150,260,275,105,860,346
2454110,2454110,Saint-Jude,85,270,365,355,145,1220,502
2454115,2454115,Saint-Bernard-de-Michaudville,40,120,175,190,70,595,259
2454120,2454120,Saint-Louis,40,120,195,240,110,705,357
2454125,2454125,Saint-Marcel-de-Richelieu,25,105,120,150,90,490,244
2455008,2455008,Ange-Gardien,225,515,945,700,320,2705,1069
2455015,2455015,Saint-Paul-d'Abbotsford,170,515,815,935,485,2920,1192
2455023,2455023,Saint-Césaire,365,1010,1905,1705,890,5875,2555
2455030,2455030,Sainte-Angèle-de-Monnoir,145,345,555,490,280,1815,724
2455037,2455037,Rougemont,175,410,795,895,480,2755,1205
2455048,2455048,Marieville,770,1850,3660,2830,1625,10735,4519
2455057,2455057,Richelieu,260,800,1405,1560,1215,5240,2247
2455065,2455065,Saint-Mathias-sur-Richelieu,210,780,1340,1410,795,4535,1959
2456005,2456005,Venise-en-Québec,60,160,290,570,555,1635,1099
2456010,2456010,Saint-Georges-de-Clarenceville,40,130,265,365,290,1090,738
2456015,2456015,Noyan,80,175,320,510,310,1395,795
2456023,2456023,Lacolle,140,420,720,790,535,2605,1189
2456030,2456030,Saint-Valentin,25,60,145,125,95,450,182
2456035,2456035,Saint-Paul-de-l'Île-aux-Noix,95,290,535,645,415,1980,1020
2456042,2456042,Henryville,85,205,395,455,260,1400,697
2456050,2456050,Saint-Sébastien,50,155,205,220,105,735,278
2456055,2456055,Saint-Alexandre,170,545,800,680,265,2460,932
2456060,2456060,Sainte-Anne-de-Sabrevois,110,355,630,630,315,2040,885
2456065,2456065,Saint-Blaise-sur-Richelieu,145,315,580,680,340,2060,872
2456083,2456083,Saint-Jean-sur-Richelieu,5205,15840,29200,27530,17345,95120,42036
2456097,2456097,Mont-Saint-Grégoire,170,575,880,1005,435,3065,1192
2456105,2456105,Sainte-Brigide-d'Iberville,120,235,455,410,175,1395,546
2457005,2457005,Chambly,2105,5925,10115,7460,3520,29125,11546
2457010,2457010,Carignan,620,1895,3060,2850,1055,9480,3572
2457020,2457020,Saint-Basile-le-Grand,985,3780,5410,4875,2010,17060,6447
2457025,2457025,McMasterville,360,1000,1915,1435,995,5705,2332
2457030,2457030,Otterburn Park,475,1810,2475,2500,1170,8430,3301
2457033,2457033,Saint-Jean-Baptiste,180,490,895,980,560,3105,1365
2457035,2457035,Mont-Saint-Hilaire,910,3350,4800,5785,3725,18570,7702
2457040,2457040,Beloeil,1480,3820,6985,6005,4185,22475,9273
2457045,2457045,Saint-Mathieu-de-Beloeil,135,475,780,835,410,2635,997
2457050,2457050,Saint-Marc-sur-Richelieu,120,365,610,705,365,2165,895
2457057,2457057,Saint-Charles-sur-Richelieu,85,250,415,615,355,1720,759
2457068,2457068,Saint-Denis-sur-Richelieu,120,400,625,740,430,2315,1043
2457075,2457075,Saint-Antoine-sur-Richelieu,85,265,435,560,340,1685,739
2458007,2458007,Brossard,4675,13640,27540,22725,17140,85720,34249
2458012,2458012,Saint-Lambert,890,3640,5035,6145,6150,21860,10446
2458033,2458033,Boucherville,1680,7395,10340,13125,9140,41680,17134
2458037,2458037,Saint-Bruno-de-Montarville,1250,5075,6575,7920,5570,26390,10418
2458227,2458227,Longueuil,13440,36710,78670,68950,41935,239705,110761
2459010,2459010,Sainte-Julie,1410,6565,8530,8985,4395,29885,11196
2459015,2459015,Saint-Amable,1020,2425,4735,3025,965,12170,4672
2459020,2459020,Varennes,1105,4100,6490,6765,2805,21265,8315
2459025,2459025,Verchères,400,1040,1765,1675,960,5840,2440
2459030,2459030,Calixa-Lavallée,15,90,140,205,80,530,221
2459035,2459035,Contrecoeur,600,1045,2640,2165,1420,7870,3688
2460005,2460005,Charlemagne,265,695,1675,1995,1280,5910,2962
2460013,2460013,Repentigny,4175,15255,24125,25780,14935,84270,33876
2460020,2460020,Saint-Sulpice,170,570,1060,1125,515,3440,1494
2460028,2460028,L'Assomption,1580,4150,7365,6115,3220,22430,8932
2460035,2460035,L'Épiphanie,390,1050,1890,1390,765,5485,2240
2460040,2460040,L'Épiphanie,210,565,980,1030,400,3185,1324
2461005,2461005,Saint-Paul,420,1085,2035,1600,740,5880,2489
2461013,2461013,Crabtree,235,760,1220,1020,720,3955,1719
2461020,2461020,Saint-Pierre,15,30,75,95,65,280,133
2461025,2461025,Joliette,980,2790,6080,5880,4760,20490,10285
2461027,2461027,Saint-Thomas,190,545,970,995,555,3255,1419
2461030,2461030,Notre-Dame-des-Prairies,385,1395,2400,2895,2190,9265,4396
2461035,2461035,Saint-Charles-Borromée,550,1870,3180,3715,4470,13785,6222
2461040,2461040,Saint-Ambroise-de-Kildare,215,710,1125,1135,675,3860,1631
2461045,2461045,Notre-Dame-de-Lourdes,200,425,885,855,435,2800,1247
2461050,2461050,Sainte-Mélanie,205,415,925,910,535,2990,1428
2462007,2462007,Saint-Félix-de-Valois,310,995,1785,1920,1300,6310,2871
2462015,2462015,Saint-Jean-de-Matha,175,490,1030,1615,1150,4460,2660
2462020,2462020,Sainte-Béatrix,90,225,445,765,430,1955,1261
2462025,2462025,Saint-Alphonse-Rodriguez,110,300,640,1290,815,3155,2344
2462030,2462030,Sainte-Marcelline-de-Kildare,60,245,430,540,310,1585,959
2462037,2462037,Rawdon,480,1610,2730,3650,2585,11055,5683
2462047,2462047,Chertsey,160,525,880,1945,1185,4695,4289
2462053,2462053,Entrelacs,20,85,155,390,275,925,1084
2462055,2462055,Notre-Dame-de-la-Merci,25,65,125,395,285,895,1215
2462060,2462060,Saint-Donat,85,390,600,1525,1300,3900,4413
2462065,2462065,Saint-Côme,90,205,450,855,585,2185,2301
2462070,2462070,Sainte-Émélie-de-l'Énergie,70,170,345,570,415,1570,1131
2462075,2462075,Saint-Damien,65,230,410,790,605,2100,1759
2462080,2462080,Saint-Zénon,15,90,185,465,365,1120,1287
2462085,2462085,Saint-Michel-des-Saints,65,280,455,930,630,2360,2025
2462802,2462802,Manawan,200,755,660,365,80,2060,416
2462902,2462902,Lac-Minaki,0,0,0,0,0,0,0
2462904,2462904,Lac-Devenyns,0,0,0,0,0,0,1
2462906,2462906,Baie-de-la-Bouteille,0,0,0,0,0,0,22
2462908,2462908,Lac-Matawin,0,0,0,0,0,0,25
2462910,2462910,Lac-Legendre,0,0,0,0,0,0,0
2462912,2462912,Saint-Guillaume-Nord,0,5,15,45,30,95,111
2462914,2462914,Lac-des-Dix-Milles,0,0,0,0,0,0,0
2462916,2462916,Lac-Santé,0,0,0,0,0,0,0
2462918,2462918,Baie-Obaoca,0,0,0,0,0,0,0
2462919,2462919,Lac-Cabasta,0,0,0,0,0,0,0
2462920,2462920,Baie-Atibenne,0,0,0,0,0,0,1
2462922,2462922,Lac-du-Taureau,0,0,0,0,0,0,0
2463005,2463005,Sainte-Marie-Salomé,80,195,325,390,205,1195,546
2463013,2463013,Saint-Jacques,185,615,1115,1220,835,3970,1743
2463023,2463023,Saint-Alexis,80,225,385,435,175,1300,564
2463030,2463030,Saint-Esprit,100,335,560,605,360,1960,872
2463035,2463035,Saint-Roch-de-l'Achigan,355,925,1690,1455,730,5155,2099
2463040,2463040,Saint-Roch-Ouest,15,50,80,80,45,270,109
2463048,2463048,Saint-Lin--Laurentides,1745,3790,7550,5435,2260,20780,8376
2463055,2463055,Saint-Calixte,295,830,1585,2230,1120,6060,3617
2463060,2463060,Sainte-Julienne,625,1565,3005,3235,1515,9945,4522
2463065,2463065,Saint-Liguori,115,325,520,605,365,1930,847
2464008,2464008,Terrebonne,6910,22925,36220,32180,13345,111580,42622
2464015,2464015,Mascouche,2935,9060,15860,12545,6285,46685,18322
2465005,2465005,Laval,22420,76585,130235,121170,72590,423000,165686
2466007,2466007,Montréal-Est,230,580,1405,1115,525,3855,1856
2466023,2466023,Montréal,98815,248760,657340,426765,273015,1704695,843872
2466032,2466032,Westmount,780,3645,5310,5325,5260,20320,9617
2466047,2466047,Montréal-Ouest,265,1035,1330,1575,855,5060,1956
2466058,2466058,Côte-Saint-Luc,1885,5405,8680,6990,9485,32445,14376
2466062,2466062,Hampstead,365,1520,1950,1905,1255,6995,2623
2466072,2466072,Mont-Royal,1095,4395,5540,5380,3860,20270,7914
2466087,2466087,Dorval,810,2740,6005,5695,3730,18980,8818
2466092,2466092,L'Île-Dorval,0,0,0,0,0,0,60
2466097,2466097,Pointe-Claire,1370,5280,7975,9270,7470,31365,12835
2466102,2466102,Kirkland,705,4045,5195,6910,3305,20160,6779
2466107,2466107,Beaconsfield,870,4185,4650,6090,3540,19335,6828
2466112,2466112,Baie-D'Urfé,125,790,745,1245,925,3830,1381
2466117,2466117,Sainte-Anne-de-Bellevue,150,865,1495,1510,935,4955,2195
2466127,2466127,Senneville,30,180,185,300,220,915,375
2466142,2466142,Dollard-Des Ormeaux,2245,9135,14080,14130,9295,48885,17627
2467005,2467005,Saint-Mathieu,140,360,665,680,305,2150,895
2467010,2467010,Saint-Philippe,405,1180,2220,1765,755,6325,2627
2467015,2467015,La Prairie,1215,4925,7310,7155,3490,24095,9947
2467020,2467020,Candiac,1250,4815,6535,5990,2450,21040,7925
2467025,2467025,Delson,435,1450,2445,2115,1025,7470,2950
2467030,2467030,Sainte-Catherine,900,3050,5310,5315,2475,17050,6845
2467035,2467035,Saint-Constant,1710,5355,9170,8080,3040,27355,10282
2467040,2467040,Saint-Isidore,160,420,825,790,420,2615,1047
2467045,2467045,Mercier,900,2665,4230,3580,1740,13115,4932
2467050,2467050,Châteauguay,2725,8635,14165,13830,8550,47905,19366
2467055,2467055,Léry,130,340,605,780,460,2315,1052
2467802,2467802,Kahnawake,0,0,0,0,0,0,
2468005,2468005,Saint-Bernard-de-Lacolle,80,255,410,530,275,1550,670
2468010,2468010,Hemmingford,30,135,205,230,155,755,387
2468015,2468015,Hemmingford,90,275,440,660,420,1885,899
2468020,2468020,Sainte-Clotilde,110,275,505,500,230,1620,704
2468025,2468025,Saint-Patrice-de-Sherrington,105,320,620,585,325,1955,808
2468030,2468030,Napierville,235,710,1260,1025,675,3905,1628
2468035,2468035,Saint-Cyprien-de-Napierville,125,370,570,575,285,1925,762
2468040,2468040,Saint-Jacques-le-Mineur,75,280,515,565,265,1700,650
2468045,2468045,Saint-Édouard,85,235,415,385,205,1325,542
2468050,2468050,Saint-Michel,195,665,1065,875,400,3200,1217
2468055,2468055,Saint-Rémi,545,1310,2695,2095,1415,8060,3522
2469005,2469005,Havelock,30,90,165,260,190,735,400
2469010,2469010,Franklin,90,240,405,560,335,1630,777
2469017,2469017,Saint-Chrysostome,175,435,720,840,460,2630,1167
2469025,2469025,Howick,55,135,275,200,110,775,352
2469030,2469030,Très-Saint-Sacrement,100,180,350,370,190,1190,498
2469037,2469037,Ormstown,190,555,900,1145,810,3600,1641
2469045,2469045,Hinchinbrooke,80,275,460,745,545,2105,1186
2469050,2469050,Elgin,20,45,100,145,75,385,221
2469055,2469055,Huntingdon,115,400,600,695,610,2420,1159
2469060,2469060,Godmanchester,80,195,355,455,310,1395,618
2469065,2469065,Sainte-Barbe,45,160,310,515,285,1315,787
2469070,2469070,Saint-Anicet,100,330,555,910,720,2615,2088
2469075,2469075,Dundee,25,50,85,130,95,385,359
2469802,2469802,Akwesasne,130,340,340,290,115,1215,763
2470005,2470005,Saint-Urbain-Premier,85,220,405,375,180,1265,530
2470012,2470012,Sainte-Martine,345,940,1850,1510,815,5460,2368
2470022,2470022,Beauharnois,640,1925,3715,3870,2720,12870,6072
2470030,2470030,Saint-Étienne-de-Beauharnois,55,140,270,260,100,825,346
2470035,2470035,Saint-Louis-de-Gonzague,105,270,450,450,220,1495,602
2470040,2470040,Saint-Stanislas-de-Kostka,85,235,465,575,305,1665,877
2470052,2470052,Salaberry-de-Valleyfield,1970,5510,11405,12155,9680,40720,19356
2471005,2471005,Rivière-Beaudette,140,350,645,635,335,2105,951
2471015,2471015,Saint-Télesphore,55,140,225,220,120,760,345
2471020,2471020,Saint-Polycarpe,160,380,785,555,340,2220,947
2471025,2471025,Saint-Zotique,600,1410,2630,2145,1145,7930,3365
2471033,2471033,Les Coteaux,385,1075,1900,1355,655,5370,2285
2471040,2471040,Coteau-du-Lac,370,1465,2070,2030,1120,7055,2743
2471045,2471045,Saint-Clet,110,295,590,545,230,1770,727
2471050,2471050,Les Cèdres,430,1305,2200,2060,765,6760,2693
2471055,2471055,Pointe-des-Cascades,100,220,525,435,185,1465,672
2471060,2471060,L'Île-Perrot,575,1865,3460,3330,1535,10765,4831
2471065,2471065,Notre-Dame-de-l'Île-Perrot,555,2365,2920,3630,1200,10670,3843
2471070,2471070,Pincourt,875,2960,4490,4210,2030,14565,5556
2471075,2471075,Terrasse-Vaudreuil,100,345,600,630,325,2000,830
2471083,2471083,Vaudreuil-Dorion,2725,7465,12820,9870,5225,38105,14853
2471090,2471090,Vaudreuil-sur-le-Lac,55,280,365,410,230,1340,504
2471095,2471095,L'Île-Cadieux,5,15,30,40,55,145,64
2471100,2471100,Hudson,180,820,1035,1780,1385,5200,2386
2471105,2471105,Saint-Lazare,985,4905,5445,6420,2140,19895,6821
2471110,2471110,Sainte-Marthe,55,160,320,385,190,1110,451
2471115,2471115,Sainte-Justine-de-Newton,45,140,265,335,140,925,426
2471125,2471125,Très-Saint-Rédempteur,60,155,255,305,115,890,371
2471133,2471133,Rigaud,420,1205,2120,2460,1580,7785,3525
2471140,2471140,Pointe-Fortune,20,95,145,220,105,585,285
2472005,2472005,Saint-Eustache,2135,7560,13000,13250,8070,44015,18742
2472010,2472010,Deux-Montagnes,1005,3275,5620,5300,2290,17490,7240
2472015,2472015,Sainte-Marthe-sur-le-Lac,1480,3480,6460,4535,2115,18070,6941
2472020,2472020,Pointe-Calumet,440,1165,2170,1905,755,6435,2696
2472025,2472025,Saint-Joseph-du-Lac,400,1320,2145,2030,805,6700,2608
2472032,2472032,Oka,195,635,960,1310,725,3825,1636
2472043,2472043,Saint-Placide,70,255,420,580,350,1675,865
2472802,2472802,Kanesatake,0,0,0,0,0,0,
2473005,2473005,Boisbriand,1735,5435,8590,8135,3000,26895,10537
2473010,2473010,Sainte-Thérèse,1030,3410,7900,7355,6295,25990,12566
2473015,2473015,Blainville,2965,13015,17375,17350,6160,56865,21006
2473020,2473020,Rosemère,560,2815,3365,4775,2425,13940,5181
2473025,2473025,Lorraine,445,2005,2390,3155,1375,9370,3381
2473030,2473030,Bois-des-Filion,500,1840,3130,2905,1255,9630,4107
2473035,2473035,Sainte-Anne-des-Plaines,885,2670,4900,4235,1730,14420,5440
2474005,2474005,Mirabel,3685,10505,18290,13130,4920,50530,20395
2475005,2475005,Saint-Colomban,1285,3310,5690,4480,1250,16015,6200
2475017,2475017,Saint-Jérôme,3825,11030,22460,21240,15800,74355,35316
2475028,2475028,Sainte-Sophie,1205,2790,5605,4495,1610,15705,6578
2475040,2475040,Prévost,710,2475,3615,4205,1995,13000,5413
2475045,2475045,Saint-Hippolyte,495,1325,2785,3160,1335,9100,5073
2476008,2476008,Saint-André-d'Argenteuil,160,440,750,1025,650,3025,1558
2476020,2476020,Lachute,550,1885,3345,3975,3105,12860,6403
2476025,2476025,Gore,85,195,455,785,390,1910,1542
2476030,2476030,Mille-Isles,60,265,415,600,235,1575,907
2476035,2476035,Wentworth,10,55,90,215,160,530,788
2476043,2476043,Brownsburg-Chatham,325,1125,1955,2350,1370,7125,3726
2476052,2476052,Grenville-sur-la-Rouge,125,375,645,985,700,2830,1916
2476055,2476055,Grenville,90,310,495,475,330,1700,862
2476065,2476065,Harrington,10,50,95,380,310,845,1379
2477011,2477011,Estérel,5,15,25,70,85,200,362
2477012,2477012,Sainte-Marguerite-du-Lac-Masson,115,285,635,1095,645,2775,2219
2477022,2477022,Sainte-Adèle,540,1655,3005,4485,3240,12925,7602
2477030,2477030,Piedmont,80,320,540,1155,860,2955,2242
2477035,2477035,Sainte-Anne-des-Lacs,190,440,870,1355,760,3615,2113
2477043,2477043,Saint-Sauveur,275,1165,1870,3610,3295,10215,6802
2477050,2477050,Morin-Heights,165,575,860,1595,955,4150,2610
2477055,2477055,Lac-des-Seize-Îles,5,10,25,70,60,170,190
2477060,2477060,Wentworth-Nord,25,110,210,595,450,1390,1989
2477065,2477065,Saint-Adolphe-d'Howard,105,345,640,1475,940,3505,3594
2478005,2478005,Val-Morin,140,390,660,1040,645,2875,2048
2478010,2478010,Val-David,200,735,1145,1720,1120,4920,3083
2478015,2478015,Lantier,25,100,195,335,195,850,805
2478020,2478020,Sainte-Lucie-des-Laurentides,55,160,305,425,305,1250,957
2478032,2478032,Sainte-Agathe-des-Monts,420,1380,2395,3370,2655,10220,6533
2478042,2478042,Ivry-sur-le-Lac,5,40,80,140,120,385,421
2478047,2478047,Saint-Faustin--Lac-Carré,205,555,1045,1110,570,3485,2517
2478050,2478050,Barkmere,0,0,15,20,15,50,367
2478055,2478055,Montcalm,25,45,105,240,210,625,666
2478060,2478060,Arundel,25,90,135,165,155,570,412
2478065,2478065,Huberdeau,35,125,210,280,205,855,533
2478070,2478070,Amherst,50,160,295,575,405,1485,1665
2478075,2478075,Brébeuf,40,130,265,365,175,975,612
2478095,2478095,Lac-Supérieur,85,260,490,690,360,1885,1674
2478100,2478100,Val-des-Lacs,25,80,155,305,185,750,844
2478102,2478102,Mont-Tremblant,345,1305,2505,3115,2380,9650,8082
2478115,2478115,La Conception,80,160,350,495,265,1350,1191
2478120,2478120,Labelle,145,325,645,775,600,2490,1999
2478127,2478127,Lac-Tremblant-Nord,0,0,0,20,15,35,67
2478130,2478130,La Minerve,25,80,145,505,460,1215,1674
2478802,2478802,Doncaster,0,0,0,0,0,0,
2479005,2479005,Notre-Dame-du-Laus,40,100,195,710,510,1555,1966
2479010,2479010,Notre-Dame-de-Pontmain,20,75,115,320,260,790,776
2479015,2479015,Lac-du-Cerf,5,50,45,185,170,455,466
2479022,2479022,Saint-Aimé-du-Lac-des-Îles,40,110,195,280,175,800,486
2479025,2479025,Kiamika,30,75,175,275,205,760,508
2479030,2479030,Nominingue,50,230,350,800,705,2135,1937
2479037,2479037,Rivière-Rouge,145,480,840,1625,1230,4320,3053
2479047,2479047,La Macaza,20,85,260,470,310,1145,1043
2479050,2479050,L'Ascension,10,75,125,330,250,790,877
2479060,2479060,Lac-Saguay,10,50,70,190,140,460,457
2479065,2479065,Chute-Saint-Philippe,35,115,175,345,275,945,854
2479078,2479078,Lac-des-Écorces,135,420,720,905,560,2740,1649
2479088,2479088,Mont-Laurier,610,2185,3825,4420,3080,14120,6890
2479097,2479097,Ferme-Neuve,115,375,665,920,635,2710,1388
2479105,2479105,Lac-Saint-Paul,0,45,80,220,130,475,409
2479110,2479110,Mont-Saint-Michel,20,65,110,185,120,500,275
2479115,2479115,Sainte-Anne-du-Lac,20,75,100,220,180,595,364
2479902,2479902,Lac-de-la-Pomme,0,0,0,0,0,0,0
2479904,2479904,Lac-Akonapwehikan,0,0,0,0,0,0,0
2479906,2479906,Lac-Wagwabika,0,0,0,0,0,0,0
2479910,2479910,Lac-Bazinet,0,0,0,0,0,0,0
2479912,2479912,Lac-De La Bidière,0,0,0,0,0,0,0
2479914,2479914,Lac-Oscar,0,0,0,0,0,0,0
2479916,2479916,Lac-de-la-Maison-de-Pierre,0,0,0,0,0,0,0
2479920,2479920,Baie-des-Chaloupes,0,0,0,0,0,0,0
2479922,2479922,Lac-Douaire,0,0,0,0,0,0,1
2479924,2479924,Lac-Ernest,0,0,0,0,0,0,0
2479926,2479926,Lac-Marguerite,0,0,0,0,0,0,0
2480005,2480005,Fassett,0,40,80,180,125,425,281
2480010,2480010,Montebello,45,115,230,310,275,975,505
2480015,2480015,Notre-Dame-de-Bonsecours,15,45,45,105,90,300,202
2480020,2480020,Notre-Dame-de-la-Paix,35,95,160,210,150,650,414
2480027,2480027,Saint-André-Avellin,140,585,840,1195,980,3740,1893
2480037,2480037,Papineauville,90,315,535,700,445,2085,1086
2480045,2480045,Plaisance,60,155,270,375,220,1080,537
2480050,2480050,Thurso,180,495,895,750,510,2830,1308
2480055,2480055,Lochaber,20,70,120,140,70,420,183
2480060,2480060,Lochaber-Partie-Ouest,60,150,270,285,105,870,339
2480065,2480065,Mayo,35,80,165,225,100,605,403
2480070,2480070,Saint-Sixte,30,75,120,185,55,465,227
2480078,2480078,Ripon,70,180,350,565,370,1535,1017
2480085,2480085,Mulgrave-et-Derry,25,30,70,160,85,370,396
2480090,2480090,Montpellier,20,95,170,400,300,985,896
2480095,2480095,Lac-Simon,30,75,140,365,335,945,1373
2480103,2480103,Chénéville,40,75,175,240,230,760,502
2480110,2480110,Namur,15,70,120,215,140,560,389
2480115,2480115,Boileau,20,30,55,130,105,340,407
2480125,2480125,Saint-Émile-de-Suffolk,20,40,105,190,130,485,433
2480130,2480130,Lac-des-Plages,10,50,70,175,130,435,704
2480135,2480135,Duhamel,5,20,35,200,175,435,1001
2480140,2480140,Val-des-Bois,25,70,125,340,295,855,851
2480145,2480145,Bowman,25,55,125,275,185,665,546
2481017,2481017,Gatineau,17200,49070,93475,77870,38615,276230,125608
2482005,2482005,L'Ange-Gardien,300,1125,1640,1800,600,5465,2058
2482010,2482010,Notre-Dame-de-la-Salette,25,105,160,285,150,725,473
2482015,2482015,Val-des-Monts,775,2070,3735,3765,1250,11595,6418
2482020,2482020,Cantley,705,2350,3555,3190,905,10705,3988
2482025,2482025,Chelsea,330,1490,1660,2555,865,6900,2898
2482030,2482030,Pontiac,345,1100,1725,1860,815,5845,2664
2482035,2482035,La Pêche,395,1270,2140,2700,1355,7860,4665
2483005,2483005,Denholm,15,55,100,240,90,500,556
2483010,2483010,Low,45,110,245,375,205,980,961
2483015,2483015,Kazabazua,60,125,215,355,185,940,825
2483020,2483020,Lac-Sainte-Marie,10,65,65,260,160,560,997
2483032,2483032,Gracefield,115,320,525,895,595,2450,2069
2483040,2483040,Cayamant,30,90,145,335,220,820,1073
2483045,2483045,Blue Sea,20,70,125,260,185,660,799
2483050,2483050,Bouchette,35,80,175,290,160,740,701
2483055,2483055,Sainte-Thérèse-de-la-Gatineau,15,35,100,220,140,510,563
2483060,2483060,Messines,70,215,400,565,365,1615,1057
2483065,2483065,Maniwaki,170,510,885,1250,1050,3865,2061
2483070,2483070,Déléage,80,245,465,630,435,1855,984
2483075,2483075,Egan-Sud,15,75,120,210,95,515,245
2483085,2483085,Bois-Franc,25,65,105,145,80,420,212
2483088,2483088,Montcerf-Lytton,25,80,150,230,140,625,333
2483090,2483090,Aumond,30,95,165,290,170,750,601
2483095,2483095,Grand-Remous,50,135,280,420,260,1145,754
2483802,2483802,Kitigan Zibi,90,320,345,300,180,1235,571
2483804,2483804,Lac-Rapide,0,0,0,0,0,0,
2483902,2483902,Lac-Pythonga,0,0,0,0,0,0,1
2483904,2483904,Cascades-Malignes,0,0,0,0,0,0,0
2483906,2483906,Lac-Lenôtre,0,0,0,0,0,0,0
2483908,2483908,Lac-Moselle,0,0,0,0,0,0,0
2483912,2483912,Dépôt-Échouani,0,0,0,0,0,0,0
2484005,2484005,Bristol,50,180,235,340,230,1035,1013
2484010,2484010,Shawville,75,250,365,420,485,1595,735
2484015,2484015,Clarendon,60,175,290,445,275,1245,924
2484020,2484020,Portage-du-Fort,15,30,65,65,50,225,150
2484025,2484025,Bryson,30,120,180,205,160,695,357
2484030,2484030,Campbell's Bay,35,120,180,215,200,750,349
2484035,2484035,L'Île-du-Grand-Calumet,20,65,105,245,190,625,457
2484040,2484040,Litchfield,20,65,130,165,90,470,449
2484045,2484045,Thorne,15,55,85,165,135,455,692
2484050,2484050,Alleyn-et-Cawood,5,15,35,45,70,170,281
2484055,2484055,Otter Lake,30,135,185,365,215,930,1068
2484060,2484060,Fort-Coulonge,85,235,375,420,300,1415,644
2484065,2484065,Mansfield-et-Pontefract,115,395,575,755,455,2295,1113
2484070,2484070,Waltham,25,60,95,125,80,385,222
2484082,2484082,L'Isle-aux-Allumettes,65,190,320,435,320,1330,1126
2484090,2484090,Chichester,10,50,75,110,85,330,227
2484095,2484095,Sheenboro,5,25,15,60,55,160,277
2484100,2484100,Rapides-des-Joachims,10,25,25,65,15,140,124
2484902,2484902,Lac-Nilgaut,0,0,0,0,0,0,0
2485005,2485005,Témiscaming,155,430,615,795,435,2430,1447
2485010,2485010,Kipawa,15,80,140,205,85,525,339
2485015,2485015,Saint-Édouard-de-Fabre,35,120,165,200,120,640,306
2485020,2485020,Béarn,45,90,200,245,115,695,386
2485025,2485025,Ville-Marie,115,365,635,765,705,2585,1350
2485030,2485030,Duhamel-Ouest,45,135,210,330,165,885,520
2485037,2485037,Lorrainville,60,255,325,395,230,1265,609
2485045,2485045,Saint-Bruno-de-Guigues,75,235,320,350,190,1170,613
2485050,2485050,Laverlochère,40,130,190,220,105,685,321
2485055,2485055,Fugèreville,20,55,90,110,60,335,222
2485060,2485060,Latulipe-et-Gaboury,10,40,60,100,85,295,203
2485065,2485065,Belleterre,15,55,75,90,70,305,199
2485070,2485070,Laforce,20,50,65,65,30,230,107
2485075,2485075,Moffet,5,15,35,70,50,175,197
2485080,2485080,Angliers,10,45,65,105,70,295,218
2485085,2485085,Saint-Eugène-de-Guigues,20,100,135,140,70,465,286
2485090,2485090,Notre-Dame-du-Nord,60,145,250,325,265,1045,536
2485095,2485095,Guérin,15,85,80,110,40,330,198
2485100,2485100,Nédélec,15,60,85,130,60,350,181
2485105,2485105,Rémigny,5,30,70,90,65,260,140
2485802,2485802,Kebaowek,10,40,70,105,45,270,138
2485803,2485803,Hunter's Point,0,0,0,0,0,0,32
2485804,2485804,Winneway,0,25,30,50,5,110,65
2485806,2485806,Timiskaming,40,140,155,140,60,535,194
2485905,2485905,Laniel,0,0,10,30,45,85,165
2485907,2485907,Les Lacs-du-Témiscamingue,0,0,0,0,0,0,20
2486042,2486042,Rouyn-Noranda,2445,7015,13155,12475,7245,42335,20568
2487005,2487005,Duparquet,40,70,170,215,165,660,389
2487010,2487010,Rapide-Danseur,25,50,85,115,45,320,195
2487015,2487015,Roquemaure,35,65,90,125,80,395,215
2487020,2487020,Gallichan,20,75,110,165,90,460,292
2487025,2487025,Palmarolle,75,265,365,455,255,1415,647
2487030,2487030,Sainte-Germaine-Boulé,90,150,300,285,170,995,421
2487035,2487035,Poularies,50,150,195,210,85,690,288
2487042,2487042,Taschereau,50,170,270,300,170,960,460
2487050,2487050,Authier,10,55,60,85,60,270,125
2487058,2487058,Macamic,165,455,730,815,585,2750,1179
2487070,2487070,Sainte-Hélène-de-Mancebourg,20,70,100,115,75,380,177
2487075,2487075,Clerval,15,45,75,150,85,370,296
2487080,2487080,La Reine,15,60,90,130,55,350,171
2487085,2487085,Dupuy,65,160,285,255,165,930,403
2487090,2487090,La Sarre,310,1180,1885,2220,1695,7290,3643
2487095,2487095,Chazel,15,50,80,95,55,295,132
2487100,2487100,Authier-Nord,15,60,85,100,40,300,164
2487105,2487105,Val-Saint-Gilles,5,30,45,50,25,155,81
2487110,2487110,Clermont,35,85,145,165,65,495,214
2487115,2487115,Normétal,50,135,190,265,155,795,415
2487120,2487120,Saint-Lambert,10,25,55,70,35,195,93
2487902,2487902,Lac-Duparquet,0,0,0,0,0,0,0
2487904,2487904,Rivière-Ojima,5,10,15,40,15,85,53
2488005,2488005,Champneuf,5,20,20,50,15,110,55
2488010,2488010,Rochebaucourt,5,20,25,45,25,120,70
2488015,2488015,La Morandière,10,25,40,85,45,205,108
2488022,2488022,Barraute,135,315,540,565,410,1965,953
2488030,2488030,La Corne,50,125,235,220,95,725,318
2488035,2488035,Landrienne,70,175,315,315,115,990,400
2488040,2488040,Saint-Marc-de-Figuery,50,170,260,270,75,825,356
2488045,2488045,La Motte,25,65,110,180,75,455,256
2488050,2488050,Saint-Mathieu-d'Harricana,50,120,245,235,95,745,332
2488055,2488055,Amos,665,2145,3730,3745,2525,12810,5910
2488060,2488060,Saint-Félix-de-Dalquier,80,175,315,250,115,935,397
2488065,2488065,Saint-Dominique-du-Rosaire,35,80,135,135,80,465,197
2488070,2488070,Berry,30,120,165,155,70,540,264
2488075,2488075,Trécesson,75,210,320,430,190,1225,558
2488080,2488080,Launay,10,35,55,90,25,215,118
2488085,2488085,Sainte-Gertrude-Manneville,55,155,240,215,130,795,314
2488090,2488090,Preissac,30,110,210,355,140,845,521
2488802,2488802,Pikogan,40,170,185,90,50,535,160
2488902,2488902,Lac-Despinassy,0,0,0,0,0,0,10
2488904,2488904,Lac-Chicobi,10,20,35,55,15,135,77
2489008,2489008,Val-d'Or,1765,5455,9955,9965,5335,32475,15352
2489010,2489010,Rivière-Héva,70,220,395,525,200,1410,702
2489015,2489015,Malartic,220,575,1025,940,600,3360,1615
2489040,2489040,Senneterre,145,455,750,930,580,2860,1448
2489045,2489045,Senneterre,40,165,255,520,225,1205,563
2489050,2489050,Belcourt,10,30,55,75,50,220,116
2489802,2489802,Kitcisakik,35,110,80,45,5,275,105
2489804,2489804,Lac-Simon,215,460,470,185,40,1370,322
2489902,2489902,Matchi-Manitou,0,0,0,0,0,0,0
2489908,2489908,Lac-Metei,0,0,0,0,0,0,0
2489910,2489910,Réservoir-Dozois,0,0,0,0,0,0,1
2489912,2489912,Lac-Granet,0,0,0,0,0,0,0
2490012,2490012,La Tuque,445,1545,2750,3630,2625,10995,6919
2490017,2490017,La Bostonnais,20,80,155,245,130,630,417
2490027,2490027,Lac-Édouard,0,15,35,90,60,200,300
2490802,2490802,Wemotaci,140,375,435,200,45,1195,305
2490804,2490804,Obedjiwan,235,695,675,340,70,2015,419
2491005,2491005,Lac-Bouchette,40,155,220,420,360,1195,926
2491010,2491010,Saint-André-du-Lac-Saint-Jean,35,70,125,160,90,480,217
2491015,2491015,Saint-François-de-Sales,25,65,125,230,155,600,429
2491020,2491020,Chambord,100,285,415,560,410,1770,1113
2491025,2491025,Roberval,480,1450,2475,3220,2415,10040,4802
2491030,2491030,Sainte-Hedwidge,35,115,230,300,160,840,473
2491035,2491035,Saint-Prime,150,520,830,820,435,2755,1252
2491042,2491042,Saint-Félicien,495,1655,2715,3190,2165,10220,5022
2491050,2491050,La Doré,85,195,335,455,290,1360,669
2491802,2491802,Mashteuiatsh,140,420,585,550,250,1945,1022
2491902,2491902,Lac-Ashuapmushuan,0,0,0,0,0,0,624
2492005,2492005,Saint-Augustin,20,70,95,90,65,340,155
2492010,2492010,Péribonka,25,75,110,200,105,515,293
2492015,2492015,Sainte-Jeanne-d'Arc,50,160,270,390,195,1065,511
2492022,2492022,Dolbeau-Mistassini,670,2215,3530,4390,3435,14240,6719
2492030,2492030,Albanel,120,410,660,710,355,2255,988
2492040,2492040,Normandin,175,475,795,915,670,3030,1375
2492045,2492045,Saint-Thomas-Didyme,20,90,125,270,165,670,548
2492050,2492050,Saint-Edmond-les-Plaines,20,60,90,125,90,385,173
2492055,2492055,Girardville,60,150,255,330,205,1000,465
2492060,2492060,Notre-Dame-de-Lorette,5,25,30,80,50,190,115
2492065,2492065,Saint-Eugène-d'Argentenay,25,75,135,160,85,480,217
2492070,2492070,Saint-Stanislas,20,65,70,140,75,370,213
2492902,2492902,Passes-Dangereuses,5,25,30,50,30,140,112
2492904,2492904,Rivière-Mistassini,0,0,0,0,0,0,32
2493005,2493005,Desbiens,55,155,275,310,235,1030,498
2493012,2493012,Métabetchouan--Lac-à-la-Croix,175,575,1000,1255,985,3990,2083
2493020,2493020,Hébertville,125,415,645,755,550,2490,1231
2493025,2493025,Hébertville-Station,95,245,395,365,205,1305,551
2493030,2493030,Saint-Bruno,210,505,920,755,425,2815,1184
2493035,2493035,Saint-Gédéon,110,280,545,680,475,2090,1228
2493042,2493042,Alma,1500,4930,8300,9540,6500,30770,14312
2493045,2493045,Saint-Nazaire,170,340,620,630,325,2085,843
2493055,2493055,Labrecque,70,240,320,465,230,1325,754
2493060,2493060,Lamarche,20,70,95,200,135,520,415
2493065,2493065,L'Ascension-de-Notre-Seigneur,125,335,625,595,290,1970,979
2493070,2493070,Saint-Henri-de-Taillon,30,115,185,315,190,835,476
2493075,2493075,Sainte-Monique,50,135,225,290,145,845,450
2493080,2493080,Saint-Ludger-de-Milot,20,90,140,250,165,665,404
2493902,2493902,Mont-Apica,0,0,0,0,0,0,0
2493904,2493904,Lac-Moncouche,0,0,0,0,0,0,0
2493906,2493906,Lac-Achouakan,0,0,0,0,0,0,0
2493908,2493908,Belle-Rivière,5,10,20,15,5,55,42
2494068,2494068,Saguenay,7205,21495,42580,44160,30490,145930,69859
2494205,2494205,Petit-Saguenay,15,75,125,255,160,630,378
2494210,2494210,L'Anse-Saint-Jean,55,120,250,450,325,1200,910
2494215,2494215,Rivière-Éternité,5,65,90,170,100,430,243
2494220,2494220,Ferland-et-Boilleau,40,80,135,195,95,545,346
2494225,2494225,Saint-Félix-d'Otis,45,100,225,380,200,950,771
2494230,2494230,Sainte-Rose-du-Nord,20,65,95,165,105,450,333
2494235,2494235,Saint-Fulgence,110,350,555,605,440,2060,1008
2494240,2494240,Saint-Honoré,455,1070,1930,1550,760,5765,2286
2494245,2494245,Saint-David-de-Falardeau,125,420,660,1015,545,2765,2102
2494250,2494250,Bégin,50,130,220,265,140,805,477
2494255,2494255,Saint-Ambroise,225,635,1085,1220,610,3775,1794
2494260,2494260,Saint-Charles-de-Bourget,35,100,205,260,140,740,354
2494265,2494265,Larouche,95,225,475,420,265,1480,778
2494926,2494926,Lalemant,0,0,0,0,0,0,0
2494928,2494928,Lac-Ministuk,0,0,0,0,0,0,0
2494930,2494930,Mont-Valin,0,0,0,0,0,0,130
2495005,2495005,Tadoussac,40,110,210,265,180,805,494
2495010,2495010,Sacré-Coeur,85,300,510,565,345,1805,896
2495018,2495018,Les Bergeronnes,35,70,170,200,175,650,372
2495025,2495025,Les Escoumins,80,265,430,655,455,1885,966
2495032,2495032,Longue-Rive,20,115,180,395,305,1015,556
2495040,2495040,Portneuf-sur-Mer,10,50,110,255,175,600,345
2495045,2495045,Forestville,150,395,720,1140,680,3085,1542
2495050,2495050,Colombier,15,70,125,275,205,690,376
2495802,2495802,Essipit,20,50,95,65,55,285,126
2495902,2495902,Lac-au-Brochet,0,0,0,0,0,0,35
2496005,2496005,Baie-Trinité,5,30,50,165,160,410,347
2496010,2496010,Godbout,5,10,35,130,95,275,191
2496015,2496015,Franquelin,10,30,65,140,60,305,207
2496020,2496020,Baie-Comeau,1040,3370,5960,7060,4090,21520,10190
2496025,2496025,Pointe-Lebel,85,310,505,685,330,1915,949
2496030,2496030,Pointe-aux-Outardes,75,215,360,460,215,1325,641
2496035,2496035,Chute-aux-Outardes,80,200,415,555,310,1560,735
2496040,2496040,Ragueneau,55,180,320,460,330,1345,631
2496802,2496802,Pessamit,150,560,765,590,195,2260,802
2496902,2496902,Rivière-aux-Outardes,0,0,10,50,25,85,151
2497007,2497007,Sept-Îles,1340,4330,7600,7780,4345,25395,12600
2497022,2497022,Port-Cartier,330,1105,2065,2140,1145,6785,3336
2497035,2497035,Fermont,190,505,1000,740,45,2480,1638
2497040,2497040,Schefferville,5,25,65,55,5,155,230
2497802,2497802,Uashat,165,475,525,335,100,1600,499
2497804,2497804,Maliotenam,180,445,505,310,95,1535,524
2497806,2497806,Kawawachikamach,50,180,195,145,40,610,174
2497808,2497808,Matimekosh,65,170,190,135,60,620,225
2497810,2497810,Lac-John,0,0,0,0,0,0,13
2497902,2497902,Rivière-Nipissis,0,0,0,0,0,0,0
2497904,2497904,Lac-Walker,5,15,35,45,20,120,66
2497906,2497906,Rivière-Mouchalagane,0,0,0,0,0,0,2
2497908,2497908,Caniapiscau,0,0,0,0,0,0,0
2497912,2497912,Lac-Juillet,0,0,0,0,0,0,0
2497914,2497914,Lac-Vacher,0,0,0,0,0,0,0
2498005,2498005,Blanc-Sablon,60,180,310,380,180,1110,460
2498010,2498010,Bonne-Espérance,25,105,140,255,160,685,296
2498012,2498012,Saint-Augustin,15,50,100,170,110,445,222
2498014,2498014,Gros-Mécatina,5,60,75,170,120,430,254
2498015,2498015,Côte-Nord-du-Golfe-du-Saint-Laurent,20,135,170,315,210,850,442
2498020,2498020,L'Île-d'Anticosti,5,25,45,100,45,220,186
2498025,2498025,Natashquan,10,20,65,95,65,255,158
2498030,2498030,Aguanish,5,25,35,130,55,250,148
2498035,2498035,Baie-Johan-Beetz,0,0,20,30,30,80,54
2498040,2498040,Havre-Saint-Pierre,205,545,1020,1120,570,3460,1641
2498045,2498045,Longue-Pointe-de-Mingan,15,55,100,150,110,430,229
2498050,2498050,Rivière-Saint-Jean,0,20,25,105,55,205,151
2498055,2498055,Rivière-au-Tonnerre,5,20,60,130,75,290,302
2498802,2498802,Pakuashipi,25,70,80,40,15,230,90
2498804,2498804,La Romaine,100,275,320,210,70,975,296
2498806,2498806,Natashquan,70,240,295,165,55,825,204
2498808,2498808,Mingan,60,155,200,100,35,550,164
2498904,2498904,Lac-Jérôme,0,0,0,0,0,0,0
2498912,2498912,Petit-Mécatina,0,0,0,0,0,0,0
2499005,2499005,Lebel-sur-Quévillon,120,375,590,755,355,2195,1155
2499010,2499010,Waswanipi,0,0,0,0,0,0,0
2499015,2499015,Matagami,90,275,455,450,175,1445,712
2499020,2499020,Chapais,85,255,435,500,235,1510,749
2499025,2499025,Chibougamau,460,1340,2445,2220,1045,7510,3538
2499030,2499030,Mistissini,0,0,0,0,0,0,0
2499035,2499035,Waskaganish,0,0,0,0,0,0,0
2499040,2499040,Nemaska,0,0,0,0,0,0,0
2499045,2499045,Eastmain,0,0,0,0,0,0,0
2499050,2499050,Wemindji,0,0,0,0,0,0,0
2499055,2499055,Chisasibi,0,0,0,0,0,0,0
2499060,2499060,Eeyou Istchee Baie-James,55,205,585,525,225,1595,903
2499065,2499065,Kawawachikamach,0,0,0,0,0,0,0
2499070,2499070,Whapmagoostui,0,0,0,0,0,0,0
2499075,2499075,Kuujjuarapik,75,200,275,125,20,695,283
2499080,2499080,Umiujaq,60,155,150,60,10,435,121
2499085,2499085,Inukjuak,230,580,630,250,65,1755,511
2499090,2499090,Kangiqsualujjuaq,120,280,350,150,40,940,218
2499095,2499095,Kuujjuaq,315,665,1100,560,120,2760,1119
2499100,2499100,Tasiujaq,55,120,145,45,10,375,91
2499105,2499105,Aupaluk,30,60,90,30,10,220,75
2499110,2499110,Kangirsuk,65,180,210,85,35,575,185
2499115,2499115,Quaqtaq,50,130,155,60,15,410,137
2499120,2499120,Puvirnituq,235,605,590,270,70,1770,628
2499125,2499125,Akulivik,90,235,195,95,15,630,187
2499130,2499130,Kangiqsujuaq,90,220,290,110,25,735,240
2499135,2499135,Salluit,165,530,535,205,55,1490,381
2499140,2499140,Ivujivik,45,150,145,60,5,405,116
2499802,2499802,Waswanipi,205,555,605,305,90,1760,524
2499804,2499804,Mistissini,285,1095,1315,635,195,3525,1068
2499806,2499806,Waskaganish,230,670,755,415,125,2195,579
2499808,2499808,Nemaska,80,200,295,155,35,765,260
2499810,2499810,Eastmain,105,275,315,140,35,870,266
2499812,2499812,Wemindji,115,395,565,275,105,1455,422
2499814,2499814,Chisasibi,475,1490,1785,835,280,4865,1177
2499816,2499816,Whapmagoostui,100,320,360,165,40,985,237
2499818,2499818,Oujé-Bougoumou,65,230,290,130,20,735,297
2499877,2499877,Kuujjuarapik,0,0,0,0,0,0,0
2499878,2499878,Umiujaq,0,0,0,0,0,0,0
2499879,2499879,Inukjuak,0,0,0,0,0,0,0
2499883,2499883,Akulivik,0,0,0,0,0,0,0
2499887,2499887,Salluit,0,0,0,0,0,0,0
2499888,2499888,Kangiqsujuaq,0,0,0,0,0,0,0
2499889,2499889,Quaqtaq,0,0,0,0,0,0,0
2499890,2499890,Kangirsuk,0,0,0,0,0,0,0
2499891,2499891,Aupaluk,0,0,0,0,0,0,0
2499892,2499892,Tasiujaq,0,0,0,0,0,0,0
2499893,2499893,Kuujjuaq,0,0,0,0,0,0,0
2499894,2499894,Kangiqsualujjuaq,0,0,0,0,0,0,0
2499895,2499895,Ivujivik,0,0,0,0,0,0,0
2499902,2499902,Rivière-Koksoak,0,0,0,0,0,0,0
2499904,2499904,Baie-d'Hudson,0,0,0,0,0,0,0
3501005,3501005,South Glengarry,515,2175,3090,4475,2905,13160,5823
3501007,3501007,Akwesasne (Part) 59,135,375,470,340,170,1490,849
3501011,3501011,South Stormont,595,2250,3420,4335,2515,13115,5277
3501012,3501012,Cornwall,2485,7155,12900,13175,10875,46590,21659
3501020,3501020,South Dundas,525,1630,2590,3415,2695,10855,4830
3501030,3501030,North Dundas,660,1840,3100,3590,2090,11280,4642
3501042,3501042,North Stormont,420,1245,2075,2155,975,6870,2717
3501050,3501050,North Glengarry,405,1535,2340,3375,2465,10120,4658
3502001,3502001,East Hawkesbury,145,485,805,1175,680,3290,1482
3502008,3502008,Hawkesbury,375,1385,2370,3335,2790,10255,5231
3502010,3502010,Champlain,305,1325,2050,3000,2025,8705,3910
3502023,3502023,Alfred and Plantagenet,530,1395,2715,3155,1875,9670,4218
3502025,3502025,The Nation / La Nation,940,2190,4270,3780,1615,12795,4917
3502036,3502036,Clarence-Rockland,1435,4365,7325,7620,3765,24510,9537
3502044,3502044,Casselman,180,630,1005,1105,645,3565,1480
3502048,3502048,Russell,935,3470,4845,5185,2075,16510,6008
3506008,3506008,Ottawa,48870,164000,316295,260925,144135,934225,395985
3507004,3507004,Edwardsburgh/Cardinal,360,1145,1880,2300,1420,7105,3110
3507006,3507006,Augusta,285,1220,1860,2405,1580,7350,3004
3507008,3507008,Prescott,165,645,1005,1280,1125,4220,2103
3507014,3507014,Elizabethtown-Kitley,355,1560,2330,3340,2260,9845,3988
3507015,3507015,Brockville,865,3065,5530,6325,5580,21365,10826
3507017,3507017,Front of Yonge,110,410,625,915,555,2615,1193
3507021,3507021,Leeds and the Thousand Islands,410,1385,2180,3300,2175,9450,4903
3507024,3507024,Gananoque,190,765,1245,1610,1345,5155,2516
3507033,3507033,Westport,15,90,95,170,205,575,354
3507040,3507040,Rideau Lakes,350,1415,2180,3555,2830,10330,6891
3507042,3507042,Athens,145,520,715,965,675,3020,1336
3507052,3507052,Merrickville-Wolford,125,475,660,1040,765,3065,1344
3507065,3507065,North Grenville,745,2945,4395,5485,2875,16445,6658
3509001,3509001,Montague,215,635,1095,1155,645,3745,1489
3509004,3509004,Smiths Falls,475,1340,2285,2575,2105,8780,4387
3509010,3509010,Drummond/North Elmsley,315,1270,1805,2660,1710,7760,3607
3509015,3509015,Tay Valley,185,735,1135,2050,1555,5660,3689
3509021,3509021,Perth,205,685,1360,1670,2005,5925,3169
3509024,3509024,Beckwith,365,1410,2110,2645,1100,7630,3100
3509028,3509028,Carleton Place,665,1815,3220,2985,1965,10650,4403
3509030,3509030,Mississippi Mills,630,2155,3285,4285,2810,13165,5536
3509039,3509039,Lanark Highlands,230,710,1285,1940,1185,5350,3315
3510005,3510005,Frontenac Islands,45,240,295,645,535,1760,1273
3510010,3510010,Kingston,5870,19090,41115,33710,24020,123805,59977
3510020,3510020,South Frontenac,900,3210,4690,6525,3310,18635,9213
3510035,3510035,Central Frontenac,150,630,900,1525,1150,4355,3726
3510045,3510045,North Frontenac,65,160,255,710,695,1885,2966
3511005,3511005,Loyalist,805,2695,4995,5065,3415,16975,6710
3511015,3511015,Greater Napanee,730,2415,4005,4875,3865,15890,7206
3511030,3511030,Stone Mills,380,1325,2055,2690,1255,7705,3440
3511035,3511035,Addington Highlands,75,280,460,800,705,2320,2328
3512001,3512001,Tyendinaga,255,795,1250,1440,555,4295,1631
3512002,3512002,Deseronto,115,295,535,520,315,1780,775
3512004,3512004,Tyendinaga Mohawk Territory,125,570,700,730,400,2525,1101
3512005,3512005,Belleville,2615,8040,14900,14395,10770,50720,22744
3512015,3512015,Quinte West,2250,7255,12370,13210,8485,43570,18646
3512020,3512020,Stirling-Rawdon,255,810,1310,1515,990,4880,2029
3512026,3512026,Centre Hastings,245,825,1215,1455,1025,4765,2161
3512030,3512030,Tweed,255,875,1415,2020,1485,6050,3023
3512036,3512036,Madoc,90,335,490,720,440,2075,889
3512046,3512046,Marmora and Lake,135,550,795,1300,1175,3955,2521
3512048,3512048,Tudor and Cashel,20,70,115,235,155,595,768
3512051,3512051,Limerick,10,50,70,130,100,360,541
3512054,3512054,Wollaston,20,70,130,270,190,680,791
3512058,3512058,Faraday,35,175,265,555,365,1395,1261
3512061,3512061,Bancroft,160,550,845,1135,1210,3900,1944
3512065,3512065,Carlow/Mayo,35,105,190,295,230,855,627
3512076,3512076,Hastings Highlands,145,545,775,1440,1180,4085,3684
3513020,3513020,Prince Edward County,890,3075,5215,8165,7375,24720,12899
3514004,3514004,Brighton,465,1600,2715,3625,3450,11855,5099
3514014,3514014,Cramahe,285,1005,1620,2200,1245,6355,2780
3514019,3514019,Hamilton,420,1780,2675,3905,2170,10950,4677
3514020,3514020,Port Hope,615,2425,4195,5300,4220,16755,7305
3514021,3514021,Cobourg,735,2675,4365,5560,6095,19430,8958
3514024,3514024,Alnwick/Haldimand,245,1180,1675,2380,1390,6870,3064
3514027,3514027,Alderville First Nation,25,80,140,165,75,485,266
3514045,3514045,Trent Hills,545,1775,2735,4245,3605,12905,6883
3515003,3515003,Asphodel-Norwood,195,670,1080,1235,920,4100,1758
3515005,3515005,Otonabee-South Monaghan,315,965,1695,2285,1410,6670,2944
3515008,3515008,Hiawatha First Nation,15,55,105,105,75,355,211
3515013,3515013,Cavan Monaghan,460,1495,2335,2840,1705,8835,3271
3515014,3515014,Peterborough,4070,12190,25420,21225,18105,81010,36785
3515015,3515015,Selwyn,755,2520,3895,5685,4205,17060,8404
3515019,3515019,Curve Lake First Nation 35,60,190,280,355,185,1070,613
3515023,3515023,Douro-Dummer,350,1115,1695,2200,1345,6705,3434
3515030,3515030,Havelock-Belmont-Methuen,160,615,930,1565,1270,4540,3936
3515037,3515037,North Kawartha,110,275,505,900,690,2480,3552
3515044,3515044,Trent Lakes,165,525,970,2110,1635,5405,5643
3516010,3516010,Kawartha Lakes,3095,10750,18140,24370,19075,75430,38444
3518001,3518001,Pickering,4545,16660,28700,28425,13450,91780,31630
3518005,3518005,Ajax,7225,24970,40645,33710,13135,119685,38105
3518009,3518009,Whitby,7210,27445,40480,36710,16540,128385,44195
3518013,3518013,Oshawa,8770,27020,51585,45730,26350,159455,64883
3518017,3518017,Clarington,5590,17770,30025,26005,12620,92010,33384
3518020,3518020,Scugog,885,3650,5400,7125,4550,21610,8697
3518022,3518022,Mississaugas of Scugog Island,10,20,60,40,0,130,61
3518029,3518029,Uxbridge,875,3995,5410,7145,3750,21175,7946
3518039,3518039,Brock,575,1930,3095,3625,2400,11625,5035
3519028,3519028,Vaughan,16265,62545,96990,86975,43475,306250,96657
3519036,3519036,Markham,17085,59400,106890,95675,49930,328980,106131
3519038,3519038,Richmond Hill,8555,37585,59830,60585,28455,195010,66465
3519044,3519044,Whitchurch-Stouffville,3220,8700,14490,12105,7315,45830,15712
3519046,3519046,Aurora,2725,11290,16530,17655,7235,55435,19381
3519048,3519048,Newmarket,4335,16645,25955,25750,11550,84235,29315
3519049,3519049,King,1250,4860,6995,7645,3770,24520,8736
3519054,3519054,East Gwillimbury,1270,4355,7110,7780,3480,23995,8279
3519070,3519070,Georgina,2505,7835,14015,14380,6675,45410,18687
3519076,3519076,Chippewas of Georgina Island First Nation,15,45,75,85,45,265,565
3520005,3520005,Toronto,136000,407655,1030975,730000,426930,2731560,1179057
3521005,3521005,Mississauga,35460,134670,239065,210615,101790,721600,248469
3521010,3521010,Brampton,37520,125540,214150,150155,66260,593625,173428
3521024,3521024,Caledon,3335,14145,19605,20645,8780,66510,22021
3522001,3522001,East Garafraxa,115,520,685,890,370,2580,922
3522008,3522008,Amaranth,180,855,1095,1365,590,4085,1376
3522010,3522010,Grand Valley,160,545,940,945,370,2960,1145
3522012,3522012,Mono,360,1630,2060,3040,1505,8595,3127
3522014,3522014,Orangeville,1770,5765,9510,7810,4055,28910,10696
3522016,3522016,Mulmur,130,585,870,1275,615,3475,1674
3522019,3522019,Melancthon,195,585,885,965,385,3015,1124
3522021,3522021,Shelburne,655,1685,2790,1840,1170,8140,2825
3523001,3523001,Puslinch,280,1230,1655,2580,1600,7345,2793
3523008,3523008,Guelph,7505,23220,47065,34785,19230,131805,55927
3523009,3523009,Guelph/Eramosa,560,2445,3360,4285,2205,12855,4604
3523017,3523017,Erin,450,2150,2905,4200,1730,11435,4258
3523025,3523025,Centre Wellington,1515,5125,7660,8155,5735,28190,11499
3523033,3523033,Mapleton,1000,2795,3160,2485,1075,10515,3556
3523043,3523043,Minto,535,1570,2380,2430,1755,8670,3370
3523050,3523050,Wellington North,795,2155,3230,3280,2460,11920,4839
3524001,3524001,Oakville,8955,42480,56095,58130,28170,193830,68617
3524002,3524002,Burlington,9275,32120,54890,51710,35315,183310,72535
3524009,3524009,Milton,9315,25465,41045,24160,10135,110120,35537
3524015,3524015,Halton Hills,3050,12990,18015,18930,8180,61165,21475
3525005,3525005,Hamilton,28275,90970,172310,152460,92905,536920,222918
3526003,3526003,Fort Erie,1265,4650,7405,10110,7290,30720,15345
3526011,3526011,Port Colborne,725,2700,4560,5825,4515,18325,9825
3526014,3526014,Wainfleet,320,1100,1605,2190,1170,6385,2977
3526021,3526021,West Lincoln,950,2935,4220,4230,2165,14500,5054
3526028,3526028,Pelham,660,2890,3965,5430,4175,17120,6596
3526032,3526032,Welland,2445,8250,15105,15355,11135,52290,23323
3526037,3526037,Thorold,915,3240,6175,5470,3005,18805,8498
3526043,3526043,Niagara Falls,4070,14360,25665,26130,17845,88070,37265
3526047,3526047,Niagara-on-the-Lake,590,2290,3670,5550,5410,17510,7964
3526053,3526053,St. Catharines,6020,20265,40685,37265,28870,133105,59879
3526057,3526057,Lincoln,1360,4175,6520,6735,5010,23800,8934
3526065,3526065,Grimsby,1465,4855,7830,7895,5265,27310,10581
3528018,3528018,Haldimand County,2460,8160,12465,14265,8270,45620,19472
3528035,3528035,New Credit (Part) 40A,10,35,35,45,20,145,57
3528037,3528037,Six Nations (Part) 40,0,0,0,0,0,0,
3528052,3528052,Norfolk County,3170,10200,16410,19860,14400,64040,28720
3529005,3529005,Brant,1885,6720,10000,11235,6865,36705,13687
3529006,3529006,Brantford,5615,17550,30610,26950,16770,97495,40732
3529020,3529020,Six Nations (Part) 40,0,0,0,0,0,0,
3529021,3529021,New Credit (Part) 40A,0,0,0,0,0,0,207
3530004,3530004,North Dumfries,545,2105,2905,3180,1470,10205,3564
3530010,3530010,Cambridge,7410,24680,42560,36390,18895,129935,49388
3530013,3530013,Kitchener,13710,40530,84595,61995,32390,233220,95495
3530016,3530016,Waterloo,4740,19150,38000,27935,15165,104990,46096
3530020,3530020,Wilmot,1305,4005,5960,5460,3820,20550,7612
3530027,3530027,Wellesley,950,2980,3215,2795,1320,11260,3403
3530035,3530035,Woolwich,1740,5155,7460,6520,4125,25000,8741
3531011,3531011,Stratford,1415,5085,9090,9355,6530,31475,14302
3531013,3531013,Perth South,195,735,1015,1275,605,3825,1431
3531016,3531016,St. Marys,360,1230,2015,1990,1665,7260,3094
3531025,3531025,West Perth,555,1775,2525,2530,1490,8875,3500
3531030,3531030,Perth East,970,2835,3515,3255,1685,12260,4080
3531040,3531040,North Perth,950,2530,3955,3335,2340,13110,5340
3532002,3532002,Norwich,885,2560,3120,2910,1520,10995,3826
3532004,3532004,Tillsonburg,730,2415,4130,4195,4410,15880,7297
3532012,3532012,South-West Oxford,510,1635,2175,2245,1110,7675,2753
3532018,3532018,Ingersoll,705,2465,3860,3710,2015,12755,5192
3532027,3532027,Zorra,480,1520,2325,2455,1360,8140,3161
3532038,3532038,East Zorra-Tavistock,380,1285,1990,2110,1385,7150,2774
3532042,3532042,Woodstock,2365,6780,12940,11040,7775,40900,17530
3532045,3532045,Blandford-Blenheim,410,1310,2150,2415,1130,7415,2817
3534005,3534005,Bayham,600,1935,2025,1885,955,7400,2557
3534010,3534010,Malahide,710,2355,2620,2390,1215,9290,3155
3534011,3534011,Aylmer,555,1430,2220,1900,1390,7495,3031
3534020,3534020,Central Elgin,525,2190,3160,4270,2455,12600,5324
3534021,3534021,St. Thomas,2075,6960,11445,10940,7480,38900,17114
3534024,3534024,Southwold,215,815,1195,1375,835,4435,1655
3534030,3534030,Dutton/Dunwich,200,675,1040,1190,755,3860,1556
3534042,3534042,West Elgin,235,835,1225,1650,1055,5000,2221
3536020,3536020,Chatham-Kent,5245,17480,27070,30445,21415,101655,46103
3536029,3536029,Moravian 47,30,105,120,105,35,395,184
3537001,3537001,Pelee,5,15,75,90,60,245,382
3537003,3537003,Leamington,1645,5100,8220,7360,5275,27600,10726
3537013,3537013,Kingsville,1125,3770,6120,6225,4320,21560,8359
3537016,3537016,Essex,905,3445,5555,6490,4040,20435,8694
3537028,3537028,Amherstburg,1045,3990,6070,6860,3975,21940,8951
3537034,3537034,LaSalle,1480,6185,8590,9295,4635,30185,10793
3537039,3537039,Windsor,11135,37520,70000,60245,38295,217195,97777
3537048,3537048,Tecumseh,955,4110,6120,7585,4460,23230,8987
3537064,3537064,Lakeshore,1880,7675,10460,11185,5420,36620,13900
3538003,3538003,St. Clair,685,2415,3875,4360,2765,14100,6243
3538004,3538004,Walpole Island 46,105,395,410,480,195,1585,782
3538007,3538007,Dawn-Euphemia,110,375,535,585,355,1960,843
3538015,3538015,Brooke-Alvinston,130,470,690,735,410,2435,994
3538016,3538016,Enniskillen,130,480,680,880,640,2810,1093
3538018,3538018,Oil Springs,40,100,175,220,115,650,285
3538019,3538019,Petrolia,305,1050,1660,1495,1225,5735,2323
3538025,3538025,Sarnia 45,45,145,190,180,100,660,274
3538030,3538030,Sarnia,3405,11115,20785,20765,15525,71595,33324
3538031,3538031,Point Edward,60,275,505,645,540,2025,995
3538035,3538035,Plympton-Wyoming,425,1375,2025,2450,1515,7790,3416
3538040,3538040,Lambton Shores,425,1315,2245,3550,3095,10630,7008
3538043,3538043,Warwick,210,750,1045,1035,660,3700,1432
3538056,3538056,Kettle Point 44,50,185,265,335,180,1015,765
3539002,3539002,Newbury,30,85,125,125,90,455,184
3539005,3539005,Southwest Middlesex,320,965,1485,1815,1130,5715,2505
3539015,3539015,Strathroy-Caradoc,1110,3795,5885,5980,4100,20870,8455
3539017,3539017,Chippewas of the Thames First Nation 42,0,0,0,0,0,0,
3539018,3539018,Munsee-Delaware Nation 1,0,0,0,0,0,0,65
3539021,3539021,Oneida 41,0,0,0,0,0,0,
3539027,3539027,Thames Centre,660,2500,3425,4375,2235,13195,5162
3539033,3539033,Middlesex Centre,900,3595,4540,5230,2995,17260,6139
3539036,3539036,London,20300,64230,131825,103715,63745,383815,175558
3539041,3539041,North Middlesex,345,1240,1730,1860,1180,6355,2399
3539047,3539047,Adelaide-Metcalfe,185,610,805,860,520,2980,1045
3539060,3539060,Lucan Biddulph,310,890,1475,1300,710,4685,1837
3540005,3540005,South Huron,515,1530,2505,2900,2660,10110,4644
3540010,3540010,Bluewater,330,1055,1755,2255,1740,7135,4532
3540025,3540025,Central Huron,380,1280,1905,2230,1780,7575,3823
3540028,3540028,Goderich,350,1115,1865,2195,2095,7620,3676
3540040,3540040,Huron East,550,1700,2575,2585,1725,9135,3825
3540046,3540046,Howick,340,925,1085,945,590,3885,1372
3540050,3540050,Morris-Turnberry,265,735,895,950,645,3490,1258
3540055,3540055,North Huron,305,910,1330,1405,995,4945,2209
3540063,3540063,Ashfield-Colborne-Wawanosh,355,900,1300,1635,1225,5415,3030
3541004,3541004,South Bruce,345,1040,1605,1700,955,5645,2381
3541015,3541015,Huron-Kinloss,470,1195,1780,2010,1620,7075,4037
3541024,3541024,Kincardine,665,1745,3110,3365,2505,11390,5883
3541032,3541032,Brockton,555,1530,2505,2865,2005,9460,4252
3541043,3541043,Arran-Elderslie,470,1240,1900,1870,1320,6800,3030
3541045,3541045,Saugeen Shores,730,1845,3675,4115,3360,13725,7655
3541055,3541055,South Bruce Peninsula,325,1075,1810,2630,2570,8410,6945
3541056,3541056,Chief's Point No. 28,0,0,0,0,0,0,55
3541057,3541057,Saugeen 29,80,240,325,300,90,1035,1466
3541060,3541060,Neyaashiinigmiing 27,55,135,175,170,85,620,410
3541069,3541069,Northern Bruce Peninsula,95,350,645,1350,1565,4005,5069
3542004,3542004,West Grey,590,2025,2940,4055,2895,12505,5648
3542005,3542005,Southgate,515,1455,2025,2325,1040,7360,2987
3542015,3542015,Grey Highlands,530,1640,2405,3045,2185,9805,5299
3542029,3542029,Hanover,350,1235,2005,2040,2075,7705,3404
3542037,3542037,Chatsworth,375,1175,1640,2070,1365,6625,2988
3542045,3542045,The Blue Mountains,200,775,1325,2390,2360,7050,6477
3542047,3542047,Meaford,485,1475,2450,3530,3055,10995,5590
3542053,3542053,Georgian Bluffs,440,1625,2450,3615,2370,10500,5069
3542059,3542059,Owen Sound,1040,3135,5830,6005,5320,21330,10098
3543003,3543003,Adjala-Tosorontio,470,1990,2955,3905,1650,10970,3974
3543005,3543005,Clearview,685,2535,3800,4510,2635,14165,6040
3543007,3543007,New Tecumseth,1850,6060,10220,9640,6470,34240,13191
3543009,3543009,Springwater,900,3805,5270,6230,2845,19050,7234
3543014,3543014,Bradford West Gwillimbury,2565,6790,12450,9470,4050,35325,11918
3543015,3543015,Severn,570,2065,3370,4605,2865,13475,6927
3543017,3543017,Innisfil,1995,6605,10985,11335,5635,36555,14875
3543019,3543019,Ramara,330,1305,2090,3320,2435,9480,6028
3543021,3543021,Essa,1360,4070,7495,5940,2210,21075,7478
3543023,3543023,Oro-Medonte,890,3605,5295,7260,3975,21025,9013
3543031,3543031,Collingwood,945,3195,5725,6180,5735,21780,11617
3543042,3543042,Barrie,7745,27385,48065,38555,19665,141415,54227
3543050,3543050,Mnjikaning First Nation 32,60,200,300,245,85,890,381
3543052,3543052,Orillia,1415,4575,8900,8860,7400,31150,14287
3543064,3543064,Wasaga Beach,725,2610,4260,6190,6905,20690,12516
3543068,3543068,Tiny,405,1545,2595,4155,3065,11765,9712
3543069,3543069,Christian Island 30,50,150,190,180,35,605,457
3543070,3543070,Christian Island 30A,0,15,15,15,0,45,14
3543071,3543071,Tay,425,1440,2650,3405,2115,10035,4931
3543072,3543072,Penetanguishene,345,1260,2365,2840,2140,8950,3990
3543074,3543074,Midland,695,2460,4325,5145,4250,16875,7739
3544002,3544002,Gravenhurst,445,1475,2990,4010,3380,12300,8302
3544018,3544018,Bracebridge,670,2395,3955,4970,4025,16015,8874
3544027,3544027,Lake of Bays,75,340,580,1145,1030,3170,4388
3544042,3544042,Huntsville,845,3080,5300,6245,4340,19810,10524
3544053,3544053,Muskoka Lakes,195,750,1440,2320,1885,6590,9343
3544065,3544065,Georgian Bay,70,270,505,905,775,2525,4700
3544071,3544071,Wahta Mohawk Territory,0,0,0,0,0,0,
3544073,3544073,Moose Point 79,15,50,75,55,30,225,76
3546005,3546005,Highlands East,100,315,550,1320,1075,3360,4485
3546015,3546015,Minden Hills,190,655,1190,2075,1975,6085,6092
3546018,3546018,Algonquin Highlands,50,205,385,860,855,2355,3453
3546024,3546024,Dysart et al,170,725,1205,2140,2045,6285,7083
3547002,3547002,Arnprior,450,1290,2380,2495,2195,8810,4124
3547003,3547003,McNab/Braeside,320,1150,1855,2495,1345,7165,3125
3547008,3547008,Greater Madawaska,80,245,455,945,785,2510,2170
3547020,3547020,"Brudenell, Lyndoch and Raglan",55,240,280,530,405,1510,963
3547030,3547030,Madawaska Valley,155,560,780,1345,1295,4135,2619
3547033,3547033,"Killaloe, Hagarty and Richards",110,425,515,770,605,2425,1689
3547035,3547035,Bonnechere Valley,145,545,765,1215,995,3665,2317
3547037,3547037,Pikwakanagan (Golden Lake 39),35,85,120,120,75,435,214
3547043,3547043,Admaston/Bromley,165,620,765,875,510,2935,1288
3547046,3547046,Horton,145,455,760,950,580,2890,1385
3547048,3547048,Renfrew,315,1180,1990,2440,2300,8225,4035
3547056,3547056,Whitewater Region,430,1170,1805,2120,1490,7015,3416
3547064,3547064,Pembroke,680,1965,3980,3760,3505,13890,6685
3547070,3547070,North Algona Wilberforce,110,430,670,1070,625,2905,1752
3547075,3547075,Laurentian Valley,470,1580,2615,3045,1670,9380,3877
3547076,3547076,Petawawa,1565,3135,7775,3305,1405,17185,6747
3547090,3547090,Laurentian Hills,210,445,935,895,485,2970,1387
3547096,3547096,Deep River,215,620,1095,1185,980,4095,1957
3547098,3547098,"Head, Clara and Maria",5,15,30,105,85,240,110
3548001,3548001,South Algonquin,20,110,205,435,330,1100,855
3548013,3548013,Papineau-Cameron,30,165,220,395,195,1005,514
3548019,3548019,Mattawan,0,30,35,65,45,175,104
3548021,3548021,Mattawa,75,300,450,660,495,1980,979
3548022,3548022,Calvin,30,90,115,165,105,505,251
3548027,3548027,Bonfield,85,290,525,740,335,1975,1052
3548031,3548031,Chisholm,90,215,340,420,220,1285,623
3548034,3548034,East Ferris,225,770,1215,1680,860,4750,2084
3548044,3548044,North Bay,2455,8175,15980,14730,10210,51550,24799
3548055,3548055,West Nipissing / Nipissing Ouest,670,2285,3430,4585,3380,14350,7013
3548069,3548069,Temagami,25,80,145,315,240,805,806
3548072,3548072,Bear Island 1,5,35,45,50,15,150,93
3548073,3548073,Nipissing 10,85,300,455,540,210,1590,758
3548091,3548091,"Nipissing, Unorganized, South Part",0,30,15,30,25,100,273
3548094,3548094,"Nipissing, Unorganized, North Part",55,270,390,705,355,1775,996
3549003,3549003,Seguin,125,605,930,1480,1170,4310,4744
3549005,3549005,The Archipelago,5,50,75,225,175,530,2693
3549012,3549012,McMurrich/Monteith,30,100,190,320,195,835,752
3549014,3549014,Perry,115,320,640,845,520,2440,1676
3549018,3549018,Kearney,20,80,180,345,255,880,1155
3549019,3549019,Armour,50,165,280,525,390,1410,1080
3549022,3549022,Burk's Falls,60,170,270,270,210,980,510
3549024,3549024,Ryerson,25,50,140,240,200,655,580
3549028,3549028,McKellar,30,100,175,420,390,1115,1520
3549031,3549031,McDougall,115,415,630,910,635,2705,1521
3549032,3549032,Parry Sound,310,825,1695,1830,1755,6415,3150
3549036,3549036,Carling,35,120,220,435,330,1140,2283
3549039,3549039,Whitestone,15,70,125,390,310,910,1410
3549043,3549043,Magnetawan,30,140,265,505,435,1375,1698
3549046,3549046,Strong,65,190,345,460,380,1440,922
3549048,3549048,Sundridge,45,135,210,265,295,950,497
3549051,3549051,Joly,10,40,55,135,85,325,164
3549054,3549054,Machar,15,105,160,300,295,875,848
3549056,3549056,South River,50,180,320,320,240,1110,528
3549060,3549060,Powassan,165,525,830,1045,885,3450,1381
3549066,3549066,Callander,175,620,965,1325,790,3875,1710
3549071,3549071,Nipissing,80,220,380,625,395,1700,1051
3549072,3549072,Shawanaga 17,5,55,55,60,25,200,93
3549073,3549073,Parry Island First Nation,25,65,90,115,30,325,372
3549075,3549075,Henvey Inlet 2,0,0,0,0,0,0,8
3549076,3549076,French River 13,5,35,35,35,5,115,54
3549077,3549077,Dokis 9,20,50,90,115,60,335,157
3549078,3549078,Magnetewan 1,15,30,30,10,5,90,37
3549095,3549095,"Parry Sound, Unorganized, North East Part",5,25,40,75,35,180,102
3549096,3549096,"Parry Sound, Unorganized, Centre Part",40,150,295,810,840,2135,2530
3551001,3551001,Tehkummah,5,50,65,155,155,430,333
3551006,3551006,Central Manitoulin,60,250,390,715,675,2090,1629
3551011,3551011,Assiginack,40,195,200,295,275,1005,730
3551017,3551017,Northeastern Manitoulin and the Islands,95,390,585,785,840,2695,2313
3551021,3551021,Billings,25,50,105,225,195,600,731
3551026,3551026,Gore Bay,30,120,160,265,295,870,447
3551027,3551027,Gordon/Barrie Island,10,50,75,175,160,470,523
3551028,3551028,Burpee and Mills,10,35,70,125,100,340,274
3551034,3551034,Cockburn Island,0,0,0,0,0,0,86
3551040,3551040,Whitefish River (Part) 4,25,110,130,140,40,445,256
3551041,3551041,Sucker Creek 23,40,80,120,85,35,360,144
3551042,3551042,Sheguiandah 24,10,30,45,30,20,135,66
3551043,3551043,Wikwemikong Unceded,230,595,710,700,265,2500,1096
3551044,3551044,Sheshegwaning 20,20,25,40,25,35,145,71
3551045,3551045,M'Chigeeng 22 (West Bay 22),55,200,285,245,95,880,485
3551094,3551094,"Manitoulin, Unorganized, West Part",0,5,10,60,85,160,332
3551100,3551100,Zhiibaahaasing 19A (Cockburn Island 19A),5,20,15,15,5,60,21
3552001,3552001,French River / Rivière des Français,105,300,520,1045,690,2660,2108
3552004,3552004,St.-Charles,50,165,205,505,310,1235,818
3552013,3552013,Markstay-Warren,145,400,720,955,435,2655,1276
3552023,3552023,Sables-Spanish Rivers,155,555,775,1110,620,3215,1675
3552026,3552026,Espanola,215,755,1355,1590,1085,5000,2351
3552028,3552028,Baldwin,30,75,140,255,115,615,277
3552031,3552031,Nairn and Hyman,15,45,80,130,60,330,190
3552036,3552036,Killarney,5,40,70,140,120,375,388
3552051,3552051,Whitefish Lake 6,20,95,125,110,50,400,240
3552052,3552052,Mattagami 71,15,45,65,55,15,195,87
3552053,3552053,Chapleau 74A,0,0,0,0,0,0,11
3552054,3552054,Duck Lake 76B,5,20,20,25,5,75,38
3552058,3552058,Chapleau 75,0,0,0,0,0,0,0
3552092,3552092,Chapleau,95,320,530,630,395,1970,1022
3552093,3552093,"Sudbury, Unorganized, North Part",80,290,495,1165,735,2765,2076
3553005,3553005,Greater Sudbury / Grand Sudbury,8155,26190,49985,47540,29665,161535,75029
3553040,3553040,Wahnapitei 11,5,25,30,40,10,110,74
3554001,3554001,Coleman,25,90,140,220,140,615,338
3554006,3554006,Latchford,10,20,60,130,80,300,227
3554008,3554008,Cobalt,55,175,270,365,240,1105,624
3554014,3554014,Harris,25,100,120,175,120,540,233
3554020,3554020,Temiskaming Shores,475,1640,2655,2825,2335,9930,4673
3554021,3554021,Hudson,25,85,115,190,85,500,280
3554024,3554024,Kerns,20,85,95,90,60,350,133
3554026,3554026,Harley,45,105,155,160,100,565,216
3554029,3554029,Casey,25,80,100,125,35,365,150
3554032,3554032,Brethour,5,20,20,25,25,95,38
3554034,3554034,Hilliard,5,35,50,90,35,215,95
3554036,3554036,Armstrong,90,205,345,310,220,1170,521
3554038,3554038,Thornloe,10,30,45,25,10,120,47
3554042,3554042,James,20,45,90,170,100,425,240
3554044,3554044,Charlton and Dack,50,155,190,195,85,675,266
3554049,3554049,Evanturel,20,85,135,120,90,450,201
3554052,3554052,Englehart,70,215,385,405,390,1465,711
3554054,3554054,Chamberlain,10,50,90,100,80,330,165
3554056,3554056,Matachewan,5,25,50,95,50,225,166
3554057,3554057,Matachewan 72,5,10,25,20,0,60,29
3554058,3554058,McGarry,35,75,115,225,170,620,345
3554062,3554062,Larder Lake,30,80,205,245,170,730,466
3554066,3554066,Gauthier,5,5,35,60,20,125,79
3554068,3554068,Kirkland Lake,420,1220,2295,2360,1685,7980,4466
3554091,3554091,"Timiskaming, Unorganized, East Part",0,0,0,0,0,0,100
3554094,3554094,"Timiskaming, Unorganized, West Part",150,500,730,1215,680,3275,2053
3556014,3556014,Black River-Matheson,105,425,590,800,530,2450,1149
3556027,3556027,Timmins,2280,7420,13130,12615,6335,41780,19317
3556031,3556031,Iroquois Falls,235,620,1145,1470,1050,4520,2245
3556033,3556033,Abitibi 70,15,30,55,40,5,145,63
3556042,3556042,Cochrane,335,920,1505,1595,975,5330,2510
3556048,3556048,Smooth Rock Falls,50,160,275,475,375,1335,693
3556052,3556052,Fauquier-Strickland,10,55,95,230,150,540,387
3556056,3556056,Moonbeam,40,170,270,470,285,1235,768
3556066,3556066,Kapuskasing,450,1285,2180,2610,1790,8315,4087
3556070,3556070,Val Rita-Harty,35,130,195,280,125,765,357
3556073,3556073,Opasatika,5,40,35,110,40,230,132
3556076,3556076,Hearst,215,810,1310,1575,1160,5070,2466
3556077,3556077,Mattice-Val Côté,20,110,145,235,125,635,338
3556091,3556091,"Cochrane, Unorganized, South West Part",0,0,0,0,0,0,2
3556092,3556092,"Cochrane, Unorganized, North Part",135,480,770,1035,455,2875,1835
3556093,3556093,Fort Albany (Part) 67,85,225,270,160,25,765,239
3556094,3556094,Factory Island 1,160,400,555,320,130,1565,501
3556095,3556095,Constance Lake 92,75,155,185,115,55,585,214
3556096,3556096,Moose Factory 68,0,0,0,0,0,0,0
3556098,3556098,"Cochrane, Unorganized, South East Part",0,0,0,0,0,0,8
3556100,3556100,Flying Post 73,0,0,0,0,0,0,0
3556102,3556102,New Post 69A,15,25,35,25,0,100,30
3556106,3556106,Moosonee,170,380,525,325,80,1480,633
3557001,3557001,Jocelyn,5,20,30,130,115,300,340
3557004,3557004,Hilton,10,35,50,95,105,295,317
3557006,3557006,Hilton Beach,5,20,35,60,55,175,128
3557008,3557008,St. Joseph,40,150,230,425,375,1220,853
3557011,3557011,Laird,65,140,265,385,190,1045,527
3557014,3557014,Tarbutt and Tarbutt Additional,25,75,140,205,80,525,400
3557016,3557016,Johnson,35,180,165,215,150,745,521
3557019,3557019,Plummer Additional,45,105,140,225,150,665,515
3557021,3557021,Bruce Mines,15,80,105,200,195,595,299
3557026,3557026,Thessalon 12,10,15,35,45,15,120,63
3557028,3557028,Thessalon,45,155,215,470,400,1285,624
3557035,3557035,Huron Shores,60,225,315,640,430,1670,1253
3557038,3557038,Blind River,155,485,800,1195,820,3455,2219
3557039,3557039,Spanish,40,85,145,260,175,705,437
3557040,3557040,The North Shore,15,45,65,205,175,505,367
3557041,3557041,Elliot Lake,360,1125,1960,3230,4075,10750,6259
3557051,3557051,"Macdonald, Meredith and Aberdeen Additional",100,260,430,520,285,1595,860
3557061,3557061,Sault Ste. Marie,3470,10830,20800,21885,16395,73380,34485
3557066,3557066,Prince,40,165,250,350,200,1005,459
3557071,3557071,Sagamok,120,280,340,280,120,1140,401
3557072,3557072,Serpent River 7,25,90,95,120,50,380,157
3557073,3557073,Mississagi River 8,30,85,130,135,20,400,185
3557074,3557074,Garden River 14,80,285,335,320,110,1130,438
3557075,3557075,Rankin Location 15D,0,0,0,0,0,0,
3557076,3557076,Wawa,140,455,795,955,570,2915,1451
3557077,3557077,Goulais Bay 15A,0,0,0,0,0,0,
3557078,3557078,Gros Cap 49,10,10,25,20,15,80,38
3557079,3557079,Dubreuilville,25,130,185,200,85,625,310
3557091,3557091,White River,35,70,180,255,95,635,411
3557094,3557094,"Algoma, Unorganized, South East Part",0,0,0,0,0,0,4
3557095,3557095,"Algoma, Unorganized, North Part",250,695,1305,2200,1300,5750,5489
3557096,3557096,Hornepayne,55,175,295,335,135,995,514
3558001,3558001,Neebing,95,325,515,765,345,2045,1166
3558003,3558003,Fort William 52,65,255,290,245,115,970,373
3558004,3558004,Thunder Bay,5015,16455,33065,31770,21605,107910,50388
3558011,3558011,Oliver Paipoonge,300,1015,1620,1985,995,5915,2289
3558012,3558012,Gillies,30,85,120,160,80,475,201
3558016,3558016,O'Connor,30,110,195,215,110,660,272
3558019,3558019,Conmee,75,140,235,270,95,815,327
3558028,3558028,Shuniah,115,330,650,1045,670,2810,2130
3558034,3558034,Dorion,15,45,70,120,75,325,174
3558041,3558041,Red Rock,45,170,210,280,205,910,444
3558044,3558044,Nipigon,85,285,380,490,405,1645,804
3558051,3558051,Schreiber,45,150,245,410,200,1050,628
3558054,3558054,Terrace Bay,70,240,410,565,320,1605,821
3558059,3558059,Marathon,140,540,960,1180,440,3260,1643
3558060,3558060,Pic Mobert North,25,60,70,40,10,205,66
3558061,3558061,Pic Mobert South,0,0,0,0,0,0,53
3558062,3558062,Pic River 50,30,120,125,135,35,445,177
3558063,3558063,Pays Plat 51,10,15,25,25,5,80,35
3558064,3558064,Lake Helen 53A,20,75,95,75,20,285,107
3558065,3558065,Gull River 55,0,0,0,0,0,0,102
3558066,3558066,Manitouwadge,75,300,470,685,410,1940,1082
3558067,3558067,Ginoogaming First Nation,15,75,70,40,15,215,64
3558068,3558068,Long Lake 58,50,120,135,60,15,380,112
3558069,3558069,Rocky Bay 1,15,40,70,45,15,185,68
3558075,3558075,Greenstone,250,785,1260,1520,820,4635,2592
3558076,3558076,Aroland 83,50,105,125,70,20,370,111
3558077,3558077,Lake Nipigon,0,0,0,0,0,0,0
3558080,3558080,Ojibway Nation of Saugeen (Savant Lake),10,30,30,20,5,95,38
3558085,3558085,Osnaburgh 63A,35,70,75,30,20,230,49
3558090,3558090,"Thunder Bay, Unorganized",250,775,1385,2280,1190,5880,6130
3558095,3558095,Seine River 22A2,0,0,0,0,0,0,0
3558097,3558097,Whitesand,0,0,0,0,0,0,105
3558100,3558100,Lac des Mille Lacs 22A1,0,0,0,0,0,0,0
3559001,3559001,Atikokan,100,440,610,970,620,2740,1477
3559011,3559011,Alberton,70,185,280,315,145,995,366
3559012,3559012,Fort Frances,365,1365,2155,2275,1580,7740,3758
3559016,3559016,La Vallee,55,160,270,310,140,935,395
3559019,3559019,Emo,95,270,375,350,245,1335,554
3559024,3559024,Chapple,35,155,175,160,115,640,313
3559026,3559026,Manitou Rapids 11,25,80,90,55,30,280,103
3559030,3559030,Long Sault 12,0,0,0,0,0,0,5
3559031,3559031,Morley,35,95,130,120,95,475,232
3559040,3559040,Dawson,20,70,75,165,125,455,292
3559042,3559042,Rainy River,35,135,155,240,245,810,434
3559047,3559047,Lake of the Woods,10,20,30,95,65,220,521
3559048,3559048,Sabaskong Bay (Part) 35C,0,0,0,0,0,0,0
3559051,3559051,Big Grassy River 35G,25,75,75,45,15,235,76
3559052,3559052,Big Island Mainland 93,0,0,0,0,0,0,2
3559053,3559053,Saug-a-Gaw-Sing 1,15,15,30,25,10,95,44
3559060,3559060,Neguaguon Lake 25D,10,45,60,45,5,165,76
3559061,3559061,Rainy Lake 18C,15,40,30,10,5,100,39
3559062,3559062,Agency 1,0,0,0,0,0,0,0
3559063,3559063,Couchiching 16A,70,230,245,180,70,795,268
3559064,3559064,Rainy Lake 26A,15,40,65,40,5,165,46
3559065,3559065,Seine River 23B,0,0,0,0,0,0,0
3559066,3559066,Seine River 23A,25,60,95,60,20,260,90
3559068,3559068,Rainy Lake 17A,25,65,65,35,15,205,76
3559069,3559069,Rainy Lake 17B,0,0,0,0,0,0,2
3559090,3559090,"Rainy River, Unorganized",50,175,250,555,355,1385,2048
3560001,3560001,Ignace,45,175,265,435,275,1195,711
3560004,3560004,Whitefish Bay 32A,55,185,180,105,40,565,191
3560005,3560005,Whitefish Bay 33A,15,25,30,20,0,90,39
3560007,3560007,Sabaskong Bay (Part) 35C,0,0,0,0,0,0,0
3560008,3560008,Sioux Narrows-Nestor Falls,15,45,110,210,195,575,797
3560010,3560010,Kenora,755,2485,4330,4610,2930,15110,7376
3560021,3560021,Machin,35,135,245,360,200,975,597
3560024,3560024,Eagle Lake 27,15,60,65,70,20,230,100
3560027,3560027,Dryden,360,1300,2105,2350,1625,7740,3541
3560032,3560032,Ear Falls,55,190,310,295,145,995,490
3560034,3560034,Sioux Lookout,350,1065,1820,1470,575,5280,2257
3560042,3560042,Red Lake,255,720,1410,1180,530,4095,1938
3560046,3560046,Slate Falls,30,55,75,30,20,210,60
3560049,3560049,Pickle Lake,30,85,130,110,40,395,223
3560050,3560050,Fort Albany (Part) 67,185,510,495,165,55,1410,284
3560051,3560051,Attawapiskat 91A,195,435,575,220,80,1505,415
3560052,3560052,Marten Falls 65,40,80,80,30,15,245,77
3560053,3560053,Fort Hope 64,145,350,345,140,45,1025,239
3560054,3560054,Cat Lake 63C,70,185,215,75,25,570,140
3560055,3560055,Osnaburgh 63B,50,170,130,65,20,435,110
3560056,3560056,Lac Seul 28,125,265,335,195,60,980,327
3560057,3560057,Wabigoon Lake 27,10,25,70,45,10,160,75
3560058,3560058,English River 21,65,175,240,140,30,650,223
3560059,3560059,Weagamow Lake 87,115,280,270,170,50,885,266
3560060,3560060,Northwest Angle 33B,0,0,0,0,0,0,43
3560061,3560061,Wabaseemoong,75,265,290,165,30,825,233
3560063,3560063,Sabaskong Bay 35D,35,110,120,80,20,365,121
3560064,3560064,Shoal Lake 34B2,10,35,60,35,10,150,57
3560065,3560065,Lake Of The Woods 37,10,15,25,10,10,70,20
3560066,3560066,Kenora 38B,30,135,165,75,25,430,144
3560067,3560067,Poplar Hill,65,185,135,75,15,475,116
3560068,3560068,Shoal Lake (Part) 39A,35,110,120,105,15,385,158
3560069,3560069,Rat Portage 38A,15,30,50,20,5,120,231
3560070,3560070,Deer Lake,120,275,310,135,30,870,244
3560071,3560071,Sandy Lake 88,255,660,680,340,80,2015,516
3560075,3560075,Kitchenuhmaykoosib Aaki 84 (Big Trout Lake),125,330,360,145,80,1040,327
3560076,3560076,Sachigo Lake 1,75,165,175,70,20,505,137
3560077,3560077,Pikangikum 14,0,0,0,0,0,0,
3560078,3560078,Fort Severn 89,35,100,135,45,30,345,100
3560079,3560079,Webequie,95,265,215,150,55,780,165
3560080,3560080,North Spirit Lake,25,105,95,50,15,290,91
3560081,3560081,Lansdowne House,0,0,0,0,0,0,0
3560082,3560082,Shoal Lake (Part) 40,10,15,25,20,0,70,23
3560083,3560083,Whitefish Bay 34A,10,35,45,20,10,120,42
3560084,3560084,Wabauskang 21,5,20,20,20,5,70,29
3560085,3560085,Wunnumin 1,60,205,215,85,25,590,143
3560086,3560086,Summer Beaver,45,120,120,65,25,375,102
3560088,3560088,Wapekeka 2,85,120,170,55,20,450,127
3560089,3560089,The Dalles 38C,20,65,60,35,10,190,60
3560090,3560090,"Kenora, Unorganized",265,945,1450,2480,1580,6720,6630
3560091,3560091,Peawanuck,15,40,60,40,30,185,82
3560093,3560093,Neskantaga,35,45,85,45,25,235,85
3560095,3560095,Bearskin Lake,35,100,125,60,35,355,140
3560096,3560096,Kasabonika Lake,110,260,295,120,50,835,212
3560097,3560097,Muskrat Dam Lake,35,90,95,45,20,285,112
3560098,3560098,Kingfisher Lake 1,55,160,175,75,45,510,114
3560100,3560100,Wawakapewin (Long Dog Lake),0,0,0,0,0,0,13
3560102,3560102,McDowell Lake,0,0,0,0,0,0,0
3560104,3560104,Kee-Way-Win,55,140,155,70,10,430,98
4601035,4601035,Stuartburn,90,360,395,475,340,1660,824
4601039,4601039,Piney,80,260,370,565,435,1710,1191
4601043,4601043,Reynolds,65,230,340,455,260,1350,727
4601046,4601046,Whitemouth,85,250,400,505,325,1565,793
4601051,4601051,Pinawa,60,150,245,480,575,1510,757
4601057,4601057,Lac du Bonnet,80,335,770,1115,820,3120,2684
4601060,4601060,Lac du Bonnet,40,170,210,315,365,1100,582
4601070,4601070,Buffalo Point 36,0,0,0,0,0,0,336
4601071,4601071,Alexander,120,390,535,1325,975,3345,4144
4601075,4601075,Powerview-Pine Falls,90,290,345,365,235,1325,580
4601078,4601078,Victoria Beach,0,20,30,125,215,390,1479
4601079,4601079,Shoal Lake (Part) 40,0,0,0,0,0,0,0
4601082,4601082,Shoal Lake (Part) 39A,0,0,0,0,0,0,0
4601094,4601094,"Division No. 1, Unorganized",15,70,160,410,380,1035,3139
4602024,4602024,Emerson-Franklin,165,555,655,700,465,2540,1082
4602026,4602026,Roseau Rapids 2A,10,45,25,25,0,105,36
4602027,4602027,Roseau River 2,80,165,190,100,10,545,162
4602032,4602032,De Salaberry,280,770,1115,955,455,3575,1231
4602037,4602037,St-Pierre-Jolys,90,245,365,255,210,1165,477
4602041,4602041,Hanover,1550,4565,5195,3285,1135,15730,4623
4602044,4602044,Steinbach,1345,3100,5530,3310,2545,15830,6305
4602046,4602046,Niverville,470,1105,1840,785,390,4590,1621
4602053,4602053,La Broquerie,570,1750,2070,1290,380,6060,1946
4602057,4602057,Ste. Anne,350,1075,1395,1390,810,5020,1905
4602061,4602061,Ste. Anne,175,420,730,415,380,2120,822
4602069,4602069,Taché,875,2955,3735,3050,965,11580,3884
4602075,4602075,Ritchot,450,1360,2310,1865,685,6670,2510
4603030,4603030,Montcalm,75,220,370,410,190,1265,527
4603040,4603040,Altona,305,780,1230,1010,890,4215,1689
4603041,4603041,Rhineland,600,1880,1855,1240,380,5955,1716
4603047,4603047,Stanley,840,3240,2785,1810,375,9050,2234
4603050,4603050,Winkler,1185,2630,4305,2715,1755,12590,4669
4603053,4603053,Morden,640,1595,2840,1990,1610,8675,3636
4603058,4603058,Thompson,130,310,415,370,200,1425,441
4603062,4603062,Roland,90,290,355,245,140,1120,386
4603065,4603065,Morris,250,765,920,755,360,3050,1024
4603067,4603067,Morris,120,350,605,465,350,1890,807
4603072,4603072,Dufferin,225,635,675,610,280,2425,794
4603074,4603074,Carman,205,485,795,730,950,3165,1496
4604034,4604034,Pembina,140,480,635,645,455,2355,999
4604040,4604040,Louise,130,305,490,525,470,1920,869
4604052,4604052,Cartwright-Roblin,110,290,365,315,220,1300,489
4604057,4604057,Argyle,45,180,220,330,250,1025,511
4604064,4604064,Lorne,205,635,755,825,630,3050,1199
4604068,4604068,Swan Lake 7,45,85,110,90,15,345,139
4605025,4605025,Killarney - Turtle Mountain,200,600,875,910,850,3435,1641
4605032,4605032,Boissevain-Morton,160,405,625,600,560,2350,1095
4605038,4605038,Deloraine-Winchester,75,235,350,445,390,1495,946
4605044,4605044,Brenda-Waskada,50,120,165,200,140,675,352
4605052,4605052,Melita,65,190,290,240,270,1055,528
4605056,4605056,Two Borders,70,205,290,370,225,1160,598
4605062,4605062,Grassland,130,310,420,420,285,1565,635
4605071,4605071,Prairie Lakes,55,215,325,515,345,1455,1150
4606016,4606016,Sifton,85,230,350,345,255,1265,784
4606023,4606023,Pipestone,90,240,385,420,320,1455,707
4606029,4606029,Canupawakpa Dakota First Nation (Oak Lake 59),30,90,100,75,20,315,106
4606031,4606031,Wallace-Woodworth,220,635,830,810,455,2950,1175
4606034,4606034,Virden,200,580,1020,750,760,3310,1576
4606040,4606040,Sioux Valley Dakota Nation,120,290,330,220,65,1025,355
4607039,4607039,Glenboro-South Cypress,130,320,425,360,320,1555,550
4607046,4607046,Oakland-Wawanesa,120,340,495,485,250,1690,655
4607052,4607052,Souris-Glenwood,155,455,750,650,550,2560,1069
4607057,4607057,Whitehead,95,355,510,495,215,1670,657
4607060,4607060,Cornwallis,410,860,1740,1065,450,4525,1783
4607062,4607062,Brandon,3245,8945,18045,11090,7535,48860,21485
4607066,4607066,North Cypress-Langford,165,595,760,795,420,2735,887
4607068,4607068,Carberry,110,305,525,385,415,1740,835
4607071,4607071,Elton,80,265,375,400,155,1275,492
4607076,4607076,Riverdale,155,410,630,575,370,2140,920
4608032,4608032,Norfolk-Treherne,130,320,455,500,365,1770,717
4608042,4608042,Victoria,95,255,345,410,415,1520,681
4608046,4608046,North Norfolk,290,865,1160,925,615,3855,1375
4608055,4608055,Glenella-Lansdowne,80,245,290,330,230,1175,442
4608060,4608060,WestLake-Gladstone,205,675,780,840,665,3165,1209
4608069,4608069,Sandy Bay 5,315,895,785,440,70,2505,584
4609018,4609018,Grey,215,505,715,775,440,2650,1065
4609024,4609024,Portage la Prairie,510,1540,1995,1965,985,6995,2502
4609025,4609025,Long Plain (Part) 6,175,420,380,200,50,1225,354
4609026,4609026,Dakota Plains 6A,0,25,20,20,5,70,41
4609027,4609027,Dakota Tipi 1,15,45,65,25,5,155,51
4609029,4609029,Portage la Prairie,930,2500,3875,3495,2495,13295,5794
4610035,4610035,Macdonald,445,1610,2225,2080,825,7185,2428
4610043,4610043,Cartier,280,810,1020,910,355,3375,853
4610052,4610052,St. François Xavier,85,290,425,430,180,1410,505
4611040,4611040,Winnipeg,39205,122775,247465,185465,110330,705240,294245
4611042,4611042,Headingley,135,625,1300,1090,435,3585,1098
4612047,4612047,Springfield,910,3005,4385,4910,2135,15345,5667
4612054,4612054,Brokenhead,325,950,1585,1575,700,5135,2115
4612056,4612056,Beausejour,155,535,865,810,845,3210,1518
4613032,4613032,East St. Paul,375,1815,2330,3285,1560,9365,3304
4613037,4613037,West St. Paul,250,1030,1475,1685,950,5390,1809
4613043,4613043,St. Andrews,475,2170,3215,4195,1855,11910,4699
4613047,4613047,Selkirk,525,1720,2925,2740,2365,10275,4328
4613049,4613049,Dunnottar,15,75,135,295,250,770,1154
4613056,4613056,St. Clements,500,1900,2785,3900,1775,10860,5359
4613062,4613062,Brokenhead 4,55,125,165,130,30,505,194
4614015,4614015,Rosser,85,260,405,425,200,1375,481
4614031,4614031,Woodlands,230,705,1015,1000,480,3430,1316
4614036,4614036,Rockwood,440,1410,2505,2425,1040,7820,2824
4614039,4614039,Stonewall,265,920,1405,1455,770,4815,1749
4614042,4614042,Teulon,65,180,320,285,340,1190,597
4615020,4615020,Neepawa,275,830,1630,945,940,4620,1628
4615032,4615032,Oakview,95,300,455,520,255,1625,659
4615037,4615037,Hamiota,60,225,285,335,325,1230,581
4615042,4615042,Birdtail Creek 57,70,130,135,65,15,415,120
4615047,4615047,Ellice-Archie,45,180,220,315,130,890,413
4615049,4615049,Gambler 63 (Part),0,0,0,0,0,0,4
4615056,4615056,Prairie View,130,345,560,625,440,2100,997
4615063,4615063,Yellowhead,90,280,410,585,600,1965,1279
4615067,4615067,Keeseekoowenin 61,35,95,130,95,20,375,160
4615070,4615070,Harrison Park,40,150,290,625,520,1625,1665
4615071,4615071,Rolling River 67,30,110,95,90,20,345,128
4615072,4615072,Rolling River 67B,15,5,15,0,0,35,11
4615074,4615074,Minto-Odanah,75,270,300,345,195,1185,442
4615075,4615075,Minnedosa,150,375,645,650,630,2450,1333
4615078,4615078,Rosedale,125,375,450,445,285,1680,621
4615092,4615092,Clanwilliam-Erickson,40,120,190,260,275,885,655
4616005,4616005,Rossburn,45,165,195,290,295,990,625
4616017,4616017,Waywayseecappo First Nation,185,445,455,205,80,1370,438
4616020,4616020,Riding Mountain West,55,215,360,520,255,1405,894
4616025,4616025,Gambler 63 (Part),15,20,20,15,5,75,32
4616030,4616030,Russell-Binscarth,135,380,675,650,595,2435,1213
4616046,4616046,Valley River 63A,35,120,110,65,25,355,111
4616048,4616048,Hillsburg-Roblin-Shell River,190,535,725,920,840,3210,1673
4617026,4617026,Alonsa,80,270,260,355,265,1230,672
4617029,4617029,Ebb and Flow 52,160,475,385,265,50,1335,391
4617035,4617035,McCreary,50,135,205,240,265,895,479
4617041,4617041,Ste. Rose,80,280,355,495,500,1710,795
4617048,4617048,Dauphin,110,445,560,825,435,2375,1105
4617050,4617050,Dauphin,485,1475,2320,1970,2210,8460,3969
4617054,4617054,Gilbert Plains,55,280,345,440,360,1480,763
4617058,4617058,Grandview,80,230,305,385,470,1470,778
4617064,4617064,Ethelbert,30,95,110,195,175,605,391
4617072,4617072,Mossey River,60,175,255,355,290,1135,618
4617075,4617075,Lakeshore,70,205,265,465,350,1355,902
4617092,4617092,"Division No. 17, Unorganized",5,10,15,30,40,100,783
4618031,4618031,Gimli,225,710,1130,2055,2065,6185,4644
4618034,4618034,Winnipeg Beach,25,100,180,440,390,1135,1547
4618037,4618037,Armstrong,100,310,430,600,345,1785,915
4618040,4618040,St. Laurent,75,230,280,480,285,1350,1157
4618044,4618044,Coldwell,55,230,305,365,295,1250,730
4618055,4618055,Dog Creek 46,105,290,280,165,35,875,235
4618056,4618056,West Interlake,125,370,530,585,555,2165,1323
4618060,4618060,Grahamdale,70,225,270,460,330,1355,1125
4618063,4618063,Little Saskatchewan 48,45,75,100,65,15,300,97
4618067,4618067,Fairford (Part) 50,170,355,350,230,60,1165,344
4618068,4618068,Fisher,110,345,405,470,380,1710,770
4618074,4618074,Arborg,90,210,375,250,310,1235,512
4618076,4618076,Bifrost-Riverton,245,805,865,915,535,3365,1583
4618091,4618091,"Division No. 18, Unorganized, East Part",0,20,20,70,55,165,546
4618093,4618093,"Division No. 18, Unorganized, West Part",0,0,0,0,0,0,0
4619045,4619045,"Division No. 19, Unorganized",235,610,660,815,465,2785,3341
4619050,4619050,Fort Alexander 3,155,645,550,435,135,1920,790
4619051,4619051,Little Grand Rapids 14,110,235,270,160,45,820,267
4619052,4619052,Bloodvein 12,95,210,240,130,15,690,198
4619053,4619053,Hole or Hollow Water 10,45,195,185,120,30,575,202
4619054,4619054,Black River 9,110,235,230,100,15,690,264
4619056,4619056,Fisher River 44,150,395,470,305,130,1450,493
4619058,4619058,Fisher River 44A,5,20,25,10,0,60,12
4619059,4619059,Peguis 1B,260,740,805,665,225,2695,948
4619060,4619060,Fairford (Part) 50,0,0,0,0,0,0,0
4619061,4619061,Jackhead 43,15,55,70,45,20,205,108
4619062,4619062,Dauphin River 48A,0,0,0,0,0,0,0
4619065,4619065,The Narrows 49,0,0,0,0,0,0,5
4619068,4619068,Crane River 51,50,155,135,85,20,445,120
4619069,4619069,Waterhen 45,40,110,115,80,35,380,125
4619070,4619070,Pine Creek 66A,65,190,205,135,40,635,241
4619071,4619071,Swan Lake 65C,0,0,0,0,0,0,6
4619072,4619072,Shoal River Indian Reserve 65A,110,300,245,130,25,810,227
4619075,4619075,Poplar River 16,115,295,260,160,40,870,231
4619077,4619077,Berens River 13,155,345,400,195,45,1140,301
4619079,4619079,Pauingassi First Nation,35,55,105,55,10,260,96
4619082,4619082,Chemawawin 3,0,0,0,0,0,0,9
4620032,4620032,Mountain (South),20,70,75,170,80,415,284
4620042,4620042,Swan Valley West,155,535,695,910,535,2830,1256
4620048,4620048,Swan River,230,670,1090,955,1075,4020,1946
4620051,4620051,Minitonas-Bowsman,75,295,430,505,345,1650,786
4620055,4620055,Mountain (North),20,105,115,190,105,535,320
4620066,4620066,"Division No. 20, Unorganized, South Part",0,10,5,30,30,75,262
4620069,4620069,"Division No. 20, Unorganized, North Part",10,10,15,20,10,65,65
4621025,4621025,Grand Rapids,45,50,95,60,20,270,135
4621027,4621027,Grand Rapids 33,105,295,235,180,50,865,234
4621029,4621029,Chemawawin 2,180,470,385,185,30,1250,298
4621033,4621033,Opaskwayak Cree Nation 21A,20,45,50,75,15,205,74
4621034,4621034,Opaskwayak Cree Nation 21B,0,0,0,0,0,0,14
4621035,4621035,Opaskwayak Cree Nation 21C,0,0,0,0,0,0,8
4621040,4621040,Opaskwayak Cree Nation 21I,10,85,85,80,25,285,99
4621043,4621043,Opaskwayak Cree Nation 21E,270,810,775,480,145,2480,629
4621045,4621045,The Pas,405,1150,1735,1320,760,5370,2349
4621052,4621052,Kelsey,145,545,705,705,310,2410,948
4621058,4621058,Moose Lake 31A,140,430,340,170,45,1125,254
4621064,4621064,Flin Flon (Part),270,865,1480,1605,760,4980,2583
4621071,4621071,Snow Lake,65,120,250,295,165,895,498
4621078,4621078,"Division No. 21, Unorganized",100,295,335,650,370,1750,1039
4622017,4622017,Mystery Lake,0,0,0,0,0,0,0
4622026,4622026,Thompson,1210,3260,5220,3195,785,13670,5482
4622046,4622046,"Division No. 22, Unorganized",225,670,740,675,235,2545,1138
4622048,4622048,Garden Hill First Nation,390,900,835,360,110,2595,611
4622049,4622049,God's Lake 23,110,300,345,175,50,980,251
4622050,4622050,Oxford House 24,270,630,655,270,115,1940,377
4622051,4622051,Cross Lake 19,175,480,535,320,95,1605,369
4622052,4622052,Cross Lake 19A,250,665,670,275,60,1920,373
4622055,4622055,God's River 86A,100,235,225,75,20,655,128
4622056,4622056,Red Sucker Lake 1976,75,250,240,90,30,685,211
4622058,4622058,Norway House 17,630,1540,1640,865,240,4915,1206
4622059,4622059,Nelson House 170,315,830,860,405,130,2540,519
4622063,4622063,Split Lake (Part) 171,260,755,605,340,80,2040,427
4622064,4622064,Ilford,5,35,35,20,10,105,31
4622065,4622065,York Landing,60,145,135,85,25,450,138
4622067,4622067,Cross Lake 19E,125,275,265,145,40,850,147
4622800,4622800,Wasagamack,190,495,490,190,30,1395,284
4622801,4622801,St. Theresa Point,445,1165,1085,455,95,3245,664
4622802,4622802,Mooseocoot,0,0,0,0,0,0,0
4623022,4623022,Gillam,115,335,485,290,45,1270,586
4623025,4623025,Gillam,0,0,0,0,0,0,0
4623027,4623027,Fox Lake 2,15,50,55,35,10,165,55
4623034,4623034,Leaf Rapids,75,170,190,115,45,595,272
4623037,4623037,South Indian Lake,125,320,335,155,50,985,236
4623039,4623039,Granville Lake,0,0,0,0,0,0,11
4623047,4623047,Lynn Lake,60,100,140,125,60,485,263
4623056,4623056,Churchill,55,180,320,250,85,890,433
4623058,4623058,Churchill 1,45,60,115,75,25,320,137
4623060,4623060,Split Lake (Part) 171,0,0,0,0,0,0,0
4623062,4623062,"Division No. 23, Unorganized",50,135,120,85,15,405,110
4623064,4623064,Pukatawagan 198,245,580,615,240,30,1710,384
4623065,4623065,Brochet 197,60,125,130,55,25,395,99
4623067,4623067,Lac Brochet 197A,80,200,280,115,50,725,178
4623071,4623071,Shamattawa 1,150,360,330,130,35,1005,203
4623800,4623800,Black Sturgeon,0,0,0,0,0,0,0
4701001,4701001,Argyle No. 1,25,65,70,90,35,285,110
4701002,4701002,Gainsborough,10,40,65,70,55,240,144
4701004,4701004,Carievale,20,50,75,65,25,235,110
4701006,4701006,Mount Pleasant No. 2,20,120,105,120,60,425,151
4701008,4701008,Carnduff,60,220,330,220,250,1080,465
4701011,4701011,Enniskillen No. 3,25,95,120,140,80,460,201
4701012,4701012,Glen Ewen,15,25,40,55,15,150,78
4701014,4701014,Oxbow,85,295,455,300,195,1330,576
4701016,4701016,Coalfields No. 4,20,55,120,120,50,365,183
4701017,4701017,Frobisher,10,40,55,55,5,165,88
4701018,4701018,North Portal,10,20,40,40,20,130,66
4701019,4701019,Roche Percée,5,15,30,40,10,100,50
4701021,4701021,Bienfait,55,135,305,210,65,770,370
4701022,4701022,Estevan No. 5,70,320,410,400,170,1370,525
4701024,4701024,Estevan,760,2070,4235,2905,1515,11485,5371
4701027,4701027,Benson No. 35,40,105,140,145,60,490,196
4701031,4701031,Browning No. 34,20,85,115,105,40,365,163
4701032,4701032,Lampman,45,130,215,165,110,665,317
4701036,4701036,Moose Creek No. 33,25,85,95,110,60,375,151
4701037,4701037,Alameda,20,65,125,85,70,365,187
4701039,4701039,Reciprocity No. 32,25,70,90,115,40,340,145
4701041,4701041,Alida,0,15,50,40,30,135,68
4701043,4701043,Storthoaks No. 31,10,80,75,100,45,310,121
4701044,4701044,Storthoaks,15,20,35,15,10,95,48
4701047,4701047,Antler No. 61,20,115,135,180,70,520,240
4701049,4701049,Redvers,70,185,355,200,235,1045,507
4701053,4701053,Moose Mountain No. 63,30,105,130,150,70,485,218
4701054,4701054,Manor,20,60,100,65,45,290,165
4701056,4701056,Carlyle,95,310,545,320,240,1510,685
4701058,4701058,Brock No. 64,10,60,75,80,50,275,122
4701059,4701059,Arcola,60,125,245,140,80,650,321
4701061,4701061,Kisbey,10,15,60,55,25,165,95
4701063,4701063,Tecumseh No. 65,10,45,70,75,65,265,126
4701064,4701064,Forget,5,10,20,15,5,55,24
4701066,4701066,Stoughton,35,100,165,160,175,635,337
4701067,4701067,Heward,5,5,20,10,0,40,20
4701069,4701069,Golden West No. 95,15,50,80,100,45,290,138
4701072,4701072,Hazelwood No. 94,10,30,55,85,50,230,112
4701076,4701076,Wawken No. 93,25,70,125,220,145,585,597
4701077,4701077,Kennedy,10,35,60,50,50,205,143
4701078,4701078,Wawota,40,85,125,120,180,550,288
4701079,4701079,Kenosee Lake,20,15,80,80,50,245,179
4701091,4701091,Walpole No. 92,25,75,85,95,55,335,149
4701094,4701094,Maryfield No. 91,20,65,90,95,45,315,132
4701096,4701096,Maryfield,30,65,90,65,95,345,178
4701098,4701098,Fairlight,0,0,5,20,15,40,21
4701808,4701808,White Bear 70,55,195,205,165,75,695,972
4701809,4701809,Ocean Man 69,25,65,55,25,20,190,61
4701810,4701810,Ocean Man 69A,0,0,0,0,0,0,0
4701812,4701812,Ocean Man 69C,0,0,0,0,0,0,0
4701813,4701813,Ocean Man 69E,0,0,0,0,0,0,0
4701814,4701814,Ocean Man 69F,0,0,0,0,0,0,0
4701815,4701815,Ocean Man 69G,0,0,0,0,0,0,0
4701816,4701816,Ocean Man 69I,0,0,0,0,0,0,1
4701817,4701817,Ocean Man 69H,0,0,0,0,0,0,3
4701818,4701818,Ocean Man 69D,0,0,0,0,0,0,2
4701819,4701819,Pheasant Rump Nakota 68,5,20,20,10,10,65,18
4702001,4702001,Cambria No. 6,25,65,90,75,40,295,115
4702002,4702002,Torquay,30,50,100,50,25,255,116
4702006,4702006,Souris Valley No. 7,20,40,60,80,60,260,128
4702008,4702008,Tribune,5,5,10,20,5,45,21
4702011,4702011,Lake Alma No. 8,20,40,50,95,35,240,112
4702012,4702012,Lake Alma,0,0,0,0,0,0,17
4702014,4702014,Surprise Valley No. 9,10,50,50,65,30,205,99
4702016,4702016,Minton,5,10,15,25,0,55,32
4702018,4702018,Happy Valley No. 10,5,30,35,40,25,135,67
4702023,4702023,Bengough,15,25,80,90,135,345,250
4702024,4702024,Bengough No. 40,20,30,65,110,65,290,136
4702026,4702026,The Gap No. 39,10,25,50,65,40,190,97
4702028,4702028,Ceylon,10,15,40,35,15,115,53
4702029,4702029,Laurier No. 38,25,70,75,100,20,290,115
4702031,4702031,Radville,45,165,225,180,185,800,390
4702033,4702033,Lomond No. 37,20,60,70,105,30,285,121
4702036,4702036,Goodwater,0,0,0,0,0,0,14
4702037,4702037,Cymri No. 36,40,110,150,160,80,540,287
4702038,4702038,Halbrite,5,20,45,40,15,125,55
4702039,4702039,Midale,45,130,210,125,85,595,264
4702041,4702041,Macoun,20,60,90,70,25,265,119
4702042,4702042,Griffin No. 66,35,95,135,130,40,435,202
4702044,4702044,Weyburn No. 67,85,235,335,275,130,1060,418
4702047,4702047,Weyburn,690,2010,3535,2570,2060,10865,5135
4702048,4702048,McTaggart,15,20,35,40,5,115,43
4702051,4702051,Brokenshell No. 68,20,65,85,90,50,310,135
4702052,4702052,Norton No. 69,5,35,45,80,50,215,122
4702054,4702054,Pangman,20,35,50,55,55,215,116
4702057,4702057,Key West No. 70,15,35,45,100,65,260,142
4702058,4702058,Ogema,35,75,115,85,95,405,191
4702061,4702061,Elmsthorpe No. 100,5,40,55,85,40,225,115
4702062,4702062,Avonlea,25,65,100,100,100,390,191
4702066,4702066,Caledonia No. 99,15,45,65,65,50,240,113
4702067,4702067,Milestone,55,150,235,150,105,695,296
4702069,4702069,Scott No. 98,20,35,60,65,20,200,94
4702071,4702071,Lang,15,35,60,55,25,190,96
4702072,4702072,Yellow Grass,55,100,185,100,40,480,212
4702073,4702073,Wellington No. 97,25,70,100,110,60,365,155
4702076,4702076,Fillmore No. 96,5,35,45,85,50,220,119
4702077,4702077,Osage,0,0,0,0,0,0,14
4702078,4702078,Fillmore,30,55,85,75,85,330,149
4702079,4702079,Creelman,10,15,40,35,20,120,75
4702800,4702800,Piapot Cree First Nation 75H,0,0,0,0,0,0,0
4703001,4703001,Hart Butte No. 11,20,45,75,85,25,250,100
4703004,4703004,Coronach,40,95,200,180,130,645,366
4703006,4703006,Poplar Valley No. 12,15,40,45,65,40,205,97
4703009,4703009,Rockglen,25,60,90,140,125,440,237
4703011,4703011,Old Post No. 43,35,65,90,120,70,380,171
4703012,4703012,Wood Mountain,0,0,0,0,0,0,10
4703016,4703016,Glen McPherson No. 46,5,15,15,35,25,95,39
4703018,4703018,Mankota No. 45,15,40,45,125,60,285,154
4703019,4703019,Mankota,5,25,40,60,85,215,137
4703022,4703022,Waverley No. 44,10,70,80,115,65,340,160
4703026,4703026,Willow Bunch No. 42,10,25,50,160,55,300,175
4703028,4703028,Willow Bunch,5,20,60,125,65,275,167
4703029,4703029,Excel No. 71,25,80,95,130,65,395,177
4703034,4703034,Lake of the Rivers No. 72,15,55,50,105,55,280,121
4703036,4703036,Assiniboia,110,350,570,645,720,2395,1210
4703038,4703038,Stonehenge No. 73,10,55,70,110,75,320,169
4703041,4703041,Limerick,10,5,25,35,35,110,65
4703042,4703042,Wood River No. 74,30,75,85,130,110,430,205
4703044,4703044,Lafleche,10,65,85,95,115,370,206
4703048,4703048,Pinto Creek No. 75,30,75,55,75,35,270,115
4703051,4703051,Kincaid,5,20,30,40,15,110,65
4703052,4703052,Hazenmore,10,10,20,20,20,80,34
4703054,4703054,Auvergne No. 76,30,100,100,115,70,415,141
4703058,4703058,Ponteix,35,100,135,115,185,570,263
4703059,4703059,Whiska Creek No. 106,30,160,140,100,40,470,142
4703061,4703061,Neville,5,20,25,30,15,95,41
4703062,4703062,Vanguard,5,25,20,40,25,115,86
4703064,4703064,Glen Bain No. 105,5,25,25,95,30,180,107
4703068,4703068,Gravelbourg No. 104,30,90,100,160,85,465,188
4703071,4703071,Gravelbourg,65,195,255,275,295,1085,524
4703074,4703074,Sutton No. 103,15,35,55,95,25,225,112
4703092,4703092,Mossbank,20,55,105,90,90,360,182
4703093,4703093,Lake Johnston No. 102,5,40,40,60,30,175,67
4703096,4703096,Terrell No. 101,15,40,60,85,30,230,126
4703801,4703801,Wood Mountain 160,0,0,0,0,0,0,14
4704002,4704002,Val Marie,10,10,35,35,30,120,80
4704003,4704003,Val Marie No. 17,35,95,125,115,55,425,114
4704006,4704006,Lone Tree No. 18,10,30,45,50,20,155,77
4704008,4704008,Bracken,0,0,0,0,0,0,13
4704009,4704009,Climax,10,40,60,55,30,195,113
4704011,4704011,Frontier No. 19,25,75,85,100,40,325,109
4704012,4704012,Frontier,30,75,120,100,55,380,186
4704019,4704019,Reno No. 51,15,75,85,125,75,375,179
4704021,4704021,Consul,0,15,10,30,20,75,40
4704024,4704024,White Valley No. 49,30,95,130,175,60,490,195
4704026,4704026,Eastend,35,40,110,145,185,515,329
4704028,4704028,Wise Creek No. 77,5,30,45,80,40,200,97
4704029,4704029,Cadillac,10,10,25,25,25,95,66
4704034,4704034,Grassy Creek No. 78,20,70,90,115,55,350,148
4704036,4704036,Shaunavon,115,295,475,455,370,1710,917
4704038,4704038,Arlington No. 79,20,90,100,100,45,355,97
4704045,4704045,Maple Creek No. 111,70,210,300,340,160,1080,538
4704048,4704048,Maple Creek,125,355,515,555,520,2070,1070
4704050,4704050,Piapot No. 110,10,45,60,115,65,295,175
4704054,4704054,Carmichael No. 109,35,110,120,120,55,440,110
4704056,4704056,Carmichael,5,15,5,20,20,65,23
4704058,4704058,Bone Creek No. 108,30,95,115,105,60,405,128
4704061,4704061,Lac Pelletier No. 107,35,110,130,190,95,560,396
4704802,4704802,Nekaneet Cree Nation,25,45,65,40,10,185,62
4705001,4705001,Moosomin No. 121,25,90,120,165,60,460,191
4705002,4705002,Fleming,5,25,35,25,10,100,35
4705004,4705004,Moosomin,165,495,880,605,615,2760,1275
4705006,4705006,Welwyn,5,20,30,30,35,120,61
4705007,4705007,Martin No. 122,20,45,65,105,50,285,130
4705009,4705009,Wapella,25,65,115,75,50,330,159
4705011,4705011,Silverwood No. 123,30,80,80,125,90,405,165
4705014,4705014,Kingsley No. 124,35,80,115,125,100,455,188
4705016,4705016,Kipling,60,195,315,225,270,1065,508
4705018,4705018,Chester No. 125,25,85,80,115,70,375,158
4705019,4705019,Windthorst,10,20,40,65,70,205,117
4705021,4705021,Glenavon,5,25,50,50,60,190,121
4705024,4705024,Wolseley,55,125,170,225,280,855,379
4705027,4705027,Wolseley No. 155,20,65,100,145,50,380,178
4705028,4705028,Elcapo No. 154,20,95,130,175,75,495,200
4705029,4705029,Grenfell,75,165,255,280,335,1110,541
4705031,4705031,Broadview,30,70,100,135,215,550,321
4705033,4705033,Willowdale No. 153,20,55,65,90,80,310,133
4705034,4705034,Whitewood,50,135,235,205,250,875,471
4705037,4705037,Rocanville No. 151,45,105,135,145,90,520,197
4705038,4705038,Rocanville,65,165,295,190,155,870,433
4705041,4705041,Spy Hill No. 152,25,60,80,115,45,325,133
4705042,4705042,Tantallon,5,0,20,35,25,85,49
4705043,4705043,Spy Hill,5,15,40,55,50,165,116
4705044,4705044,Gerald,10,30,50,45,15,150,65
4705047,4705047,Langenburg No. 181,30,125,145,170,90,560,246
4705048,4705048,Langenburg,65,225,330,260,270,1150,549
4705049,4705049,Yarbo,5,5,25,10,10,55,38
4705050,4705050,West End,0,0,0,0,0,0,74
4705051,4705051,Fertile Belt No. 183,35,130,180,285,135,765,377
4705052,4705052,Esterhazy,145,420,745,655,540,2505,1333
4705053,4705053,Atwater,0,0,0,0,0,0,16
4705054,4705054,Bangor,0,0,0,0,0,0,14
4705055,4705055,Bird's Point,5,5,15,55,20,100,131
4705056,4705056,Stockholm,15,55,90,120,75,355,178
4705057,4705057,Grayson No. 184,15,90,95,205,100,505,324
4705058,4705058,Dubuc,5,5,25,20,15,70,46
4705059,4705059,Grayson,10,20,55,65,65,215,117
4705060,4705060,Melville Beach,0,0,0,0,0,0,60
4705061,4705061,Waldron,0,0,0,0,0,0,12
4705062,4705062,Killaly,5,15,30,15,0,65,48
4705063,4705063,McLeod No. 185,20,50,100,145,60,375,190
4705064,4705064,Neudorf,10,40,55,70,85,260,167
4705066,4705066,Lemberg,15,55,70,85,90,315,162
4705067,4705067,Stanley No. 215,20,85,115,180,100,500,240
4705068,4705068,Duff,0,0,0,0,0,0,23
4705069,4705069,Goodeve,0,0,0,20,10,30,34
4705071,4705071,Fenwood,0,0,0,0,0,0,22
4705073,4705073,Cana No. 214,40,185,220,295,125,865,372
4705074,4705074,Melville,240,725,1265,1170,1190,4590,2329
4705077,4705077,Saltcoats No. 213,60,155,170,220,100,705,285
4705078,4705078,Saltcoats,25,85,140,125,105,480,228
4705079,4705079,Bredenbury,25,60,140,85,60,370,177
4705093,4705093,Churchbridge No. 211,35,120,155,200,115,625,268
4705094,4705094,Churchbridge,65,160,265,245,160,895,420
4705096,4705096,MacNutt,0,15,20,20,10,65,41
4705803,4705803,Cowessess 73,55,150,145,125,65,540,214
4705804,4705804,Kahkewistahaw 72,55,175,140,105,25,500,184
4705805,4705805,Sakimay 74,20,50,45,30,10,155,170
4705806,4705806,Ochapowace 71,45,155,110,80,20,410,138
4705807,4705807,Shesheep 74A,0,0,10,35,65,110,179
4705808,4705808,Little Bone 74B,0,0,0,0,0,0,8
4705814,4705814,Ochapowace 71-10,0,0,0,0,0,0,0
4705818,4705818,Ochapowace 71-54,0,0,0,0,0,0,0
4705821,4705821,Ochapowace 71-26,0,0,0,0,0,0,0
4705822,4705822,Ochapowace 71-70,0,0,0,0,0,0,0
4705823,4705823,Ochapowace 71-7,0,0,0,0,0,0,0
4705824,4705824,Ochapowace 71-18,0,0,0,0,0,0,0
4705825,4705825,Ochapowace 71-51,0,0,0,0,0,0,0
4705826,4705826,Ochapowace 71-44,0,0,0,0,0,0,0
4706001,4706001,Montmartre No. 126,35,115,115,160,65,490,188
4706002,4706002,Montmartre,20,95,105,125,150,495,248
4706003,4706003,Kendal,5,15,25,30,10,85,46
4706004,4706004,Francis No. 127,45,145,175,250,70,685,264
4706006,4706006,Odessa,10,30,70,65,35,210,96
4706007,4706007,Vibank,25,60,125,115,50,375,181
4706008,4706008,Sedley,45,60,130,95,30,360,136
4706009,4706009,Francis,15,45,70,40,35,205,94
4706011,4706011,Lajord No. 128,90,230,350,395,160,1225,473
4706013,4706013,Bratt's Lake No. 129,20,55,80,115,50,320,149
4706014,4706014,Wilcox,10,70,85,85,10,260,93
4706016,4706016,Redburn No. 130,15,55,55,85,40,250,107
4706017,4706017,Rouleau,35,125,165,140,70,535,224
4706018,4706018,Briercrest,15,25,40,45,25,150,67
4706019,4706019,Drinkwater,5,15,25,20,15,80,32
4706021,4706021,Pense No. 160,45,100,150,140,75,510,189
4706022,4706022,Belle Plaine,5,15,25,30,5,80,43
4706023,4706023,Pense,40,140,210,140,55,585,228
4706026,4706026,Sherwood No. 159,40,115,380,300,135,970,325
4706027,4706027,Regina,14040,37805,79810,53710,29740,215105,93197
4706028,4706028,Grand Coulee,55,175,235,160,20,645,202
4706029,4706029,Edenwold No. 158,265,1060,1285,1445,440,4495,1546
4706030,4706030,White City,290,750,1085,770,190,3085,1036
4706031,4706031,Pilot Butte,145,445,735,610,200,2135,791
4706032,4706032,Balgonie,120,440,630,430,145,1765,611
4706033,4706033,Edenwold,15,50,100,55,20,240,92
4706034,4706034,South Qu'Appelle No. 157,65,260,325,445,175,1270,528
4706036,4706036,Qu'Appelle,40,105,210,200,95,650,325
4706037,4706037,McLean,40,100,170,70,25,405,158
4706038,4706038,Indian Head No. 156,15,65,75,125,45,325,166
4706039,4706039,Indian Head,100,360,535,465,445,1905,900
4706041,4706041,Sintaluta,10,20,40,40,15,125,80
4706042,4706042,Abernethy No. 186,10,75,80,130,75,370,196
4706045,4706045,Fort San,0,40,35,105,35,215,178
4706046,4706046,Abernethy,15,35,50,55,30,185,104
4706047,4706047,Balcarres,25,85,140,165,175,590,278
4706048,4706048,North Qu'Appelle No. 187,35,130,165,310,205,845,761
4706049,4706049,Lebret,15,50,55,70,40,230,142
4706050,4706050,Katepwa,5,20,40,135,120,320,808
4706051,4706051,Fort Qu'Appelle,110,350,485,470,610,2025,948
4706052,4706052,B-Say-Tah,0,15,20,70,55,160,237
4706053,4706053,Lumsden No. 189,110,345,500,705,285,1945,774
4706054,4706054,Disley,5,10,20,20,5,60,33
4706055,4706055,Buena Vista,25,100,140,225,110,600,417
4706056,4706056,Lumsden,105,365,530,510,320,1830,722
4706057,4706057,Lumsden Beach,0,0,0,0,0,0,59
4706058,4706058,Regina Beach,45,150,300,385,260,1140,981
4706059,4706059,Dufferin No. 190,30,100,170,180,80,560,327
4706060,4706060,Wee Too Beach,5,0,20,35,20,80,140
4706061,4706061,Bethune,20,95,125,105,55,400,181
4706062,4706062,Findlater,5,0,5,30,0,40,34
4706063,4706063,Sarnia No. 221,25,55,75,110,50,315,255
4706064,4706064,Chamberlain,10,5,35,40,5,95,56
4706065,4706065,Alice Beach,0,0,15,10,20,45,131
4706067,4706067,Holdfast,20,45,80,60,55,260,136
4706068,4706068,Dilke,0,5,15,35,35,90,107
4706069,4706069,Grandview Beach,0,0,0,0,0,0,172
4706070,4706070,Longlaketon No. 219,65,190,265,370,120,1010,420
4706071,4706071,McKillop No. 220,35,65,135,330,165,730,617
4706072,4706072,Saskatchewan Beach,5,35,60,100,55,255,348
4706073,4706073,Bulyea,5,20,35,35,20,115,54
4706074,4706074,Strasbourg,40,115,180,205,250,790,394
4706075,4706075,Kannata Valley,0,0,5,45,20,70,132
4706076,4706076,Sunset Cove,0,0,0,0,0,0,50
4706077,4706077,Silton,5,5,15,40,20,85,48
4706078,4706078,Craven,10,40,65,70,30,215,104
4706079,4706079,Earl Grey,0,35,60,75,60,230,121
4706080,4706080,Glen Harbour,0,0,5,40,15,60,77
4706081,4706081,North Grove,5,15,35,55,35,145,165
4706082,4706082,Pelican Pointe,0,0,0,0,0,0,55
4706085,4706085,Island View,0,10,15,45,20,90,237
4706091,4706091,Cupar No. 218,20,95,140,185,75,515,222
4706092,4706092,Southey,70,170,270,155,150,815,357
4706093,4706093,Markinch,5,5,20,25,10,65,31
4706094,4706094,Cupar,35,90,165,105,170,565,276
4706096,4706096,Lipton No. 217,20,70,90,145,70,395,189
4706097,4706097,Dysart,5,30,25,65,65,190,115
4706098,4706098,Lipton,25,65,90,95,75,350,173
4706099,4706099,Tullymet No. 216,5,30,45,70,45,195,105
4706809,4706809,Piapot 75,60,150,170,105,25,510,171
4706810,4706810,Assiniboine 76,35,105,125,130,50,445,214
4706811,4706811,Standing Buffalo 78,50,175,185,125,40,575,198
4706812,4706812,Pasqua 79,65,150,160,110,40,525,200
4706813,4706813,Muscowpetung 80,35,80,75,55,30,275,112
4706814,4706814,Little Black Bear 84,15,40,45,25,5,130,43
4706815,4706815,Okanese 82,10,65,60,25,10,170,69
4706816,4706816,Peepeekisis 81,50,155,150,90,45,490,146
4706818,4706818,Star Blanket 83,25,45,40,45,20,175,59
4706820,4706820,Wa-Pii Moos-Toosis (White Calf) 83A,5,25,20,25,10,85,28
4706828,4706828,Star Blanket 83C,0,0,0,0,0,0,1
4706829,4706829,Treaty Four Reserve Grounds 77,0,0,0,0,0,0,8
4707001,4707001,Baildon No. 131,55,115,165,165,110,610,219
4707004,4707004,Hillsborough No. 132,0,20,30,35,15,100,54
4707006,4707006,Rodgers No. 133,10,10,25,20,20,85,65
4707008,4707008,Coderre,0,0,0,0,0,0,19
4707011,4707011,Shamrock No. 134,5,45,25,75,55,205,99
4707012,4707012,Shamrock,0,0,0,0,0,0,18
4707014,4707014,Lawtonia No. 135,20,75,85,125,45,350,123
4707016,4707016,Hodgeville,10,30,45,45,40,170,97
4707018,4707018,Coulee No. 136,50,125,170,155,70,570,205
4707020,4707020,Beaver Flat,0,5,5,35,30,75,127
4707021,4707021,Excelsior No. 166,55,180,215,220,125,795,244
4707022,4707022,Waldeck,15,50,100,80,35,280,117
4707023,4707023,Rush Lake,5,0,15,10,5,35,27
4707024,4707024,Morse No. 165,35,75,110,140,65,425,160
4707026,4707026,Herbert,55,135,205,200,250,845,356
4707027,4707027,Morse,10,30,50,80,80,250,150
4707028,4707028,Ernfold,0,0,0,0,0,0,13
4707029,4707029,Chaplin No. 164,0,25,20,40,25,110,51
4707031,4707031,Chaplin,15,25,55,80,45,220,146
4707032,4707032,Wheatlands No. 163,5,20,40,50,35,150,71
4707034,4707034,Mortlach,20,45,65,65,70,265,117
4707036,4707036,Caron No. 162,45,95,140,205,85,570,234
4707037,4707037,Caronport,85,260,345,235,70,995,372
4707038,4707038,Moose Jaw No. 161,80,185,405,360,130,1160,524
4707039,4707039,Moose Jaw,2055,5950,10355,8995,6530,33885,15866
4707042,4707042,Marquis No. 191,10,50,70,105,50,285,205
4707043,4707043,Tuxford,5,25,35,40,15,120,44
4707044,4707044,Marquis,5,15,40,20,20,100,40
4707045,4707045,Sun Valley,0,20,15,60,25,120,161
4707046,4707046,Keeler,0,0,0,0,0,0,10
4707047,4707047,Eyebrow No. 193,15,35,40,70,40,200,89
4707048,4707048,Brownlee,5,10,15,30,15,75,29
4707049,4707049,Eyebrow,5,10,15,60,40,130,61
4707051,4707051,South Lake,5,15,25,75,45,165,321
4707053,4707053,Enfield No. 194,15,40,35,85,40,215,97
4707054,4707054,Central Butte,5,35,85,100,150,375,219
4707058,4707058,Canaan No. 225,10,25,30,40,25,130,56
4707059,4707059,Lucky Lake,20,35,75,80,85,295,154
4707062,4707062,Beechy,15,25,60,65,65,230,147
4707063,4707063,Victory No. 226,30,65,100,120,75,390,230
4707066,4707066,King George No. 256,10,45,55,70,50,230,89
4707067,4707067,Coteau No. 255,30,95,90,150,105,470,318
4707068,4707068,Coteau Beach,0,0,10,15,20,45,128
4707071,4707071,Maple Bush No. 224,15,15,50,50,55,185,164
4707072,4707072,Riverhurst,5,20,15,50,45,135,114
4707074,4707074,Mistusinne,0,0,5,25,40,70,244
4707076,4707076,Huron No. 223,10,30,45,65,45,195,51
4707077,4707077,Tugaske,0,5,10,30,15,60,66
4707091,4707091,Craik No. 222,10,35,65,100,65,275,137
4707092,4707092,Craik,10,60,70,130,110,380,217
4707093,4707093,Aylesbury,5,0,10,10,15,40,30
4708001,4708001,Swift Current No. 137,105,430,535,605,260,1935,743
4708004,4708004,Swift Current,955,2730,5220,4425,3270,16600,7650
4708006,4708006,Webb No. 138,25,125,125,170,100,545,254
4708008,4708008,Webb,0,10,10,30,5,55,26
4708009,4708009,Gull Lake No. 139,15,40,40,75,35,205,89
4708011,4708011,Gull Lake,45,185,305,245,270,1050,489
4708012,4708012,Tompkins,5,20,20,50,60,155,104
4708016,4708016,Big Stick No. 141,5,25,40,55,25,150,74
4708018,4708018,Golden Prairie,0,0,0,0,0,0,29
4708021,4708021,Enterprise No. 142,10,10,30,50,10,110,79
4708022,4708022,Richmound,5,30,40,50,30,155,78
4708024,4708024,Fox Valley No. 171,20,90,95,90,40,335,85
4708026,4708026,Fox Valley,15,55,60,85,30,245,133
4708028,4708028,Pittville No. 169,25,30,60,65,45,225,107
4708029,4708029,Hazlet,10,20,30,25,30,115,59
4708031,4708031,Riverside No. 168,25,85,100,175,90,475,205
4708032,4708032,Cabri,25,45,85,120,120,395,234
4708034,4708034,Pennant,10,20,35,40,20,125,68
4708036,4708036,Success,0,10,5,10,15,40,21
4708038,4708038,Saskatchewan Landing No. 167,15,70,115,145,65,410,149
4708039,4708039,Stewart Valley,0,15,30,35,10,90,54
4708042,4708042,Lacadena No. 228,20,70,100,230,120,540,553
4708044,4708044,Kyle,20,45,110,125,150,450,244
4708046,4708046,Miry Creek No. 229,20,70,95,125,65,375,127
4708048,4708048,Abbey,5,20,25,40,35,125,88
4708049,4708049,Lancer,5,10,15,30,15,75,35
4708053,4708053,Clinworth No. 230,10,10,35,65,15,135,77
4708054,4708054,Sceptre,5,10,20,35,20,90,54
4708056,4708056,Happyland No. 231,20,35,55,100,40,250,113
4708057,4708057,Prelate,15,30,45,40,20,150,77
4708058,4708058,Leader,60,130,240,235,190,855,420
4708059,4708059,Mendham,0,0,0,0,0,0,20
4708061,4708061,Deer Forks No. 232,5,20,20,45,25,115,56
4708062,4708062,Burstall,25,85,90,110,75,385,158
4708065,4708065,Chesterfield No. 261,35,95,130,145,80,485,165
4708068,4708068,Eatonia,25,100,145,135,110,515,248
4708071,4708071,Newcombe No. 260,25,75,90,115,30,335,119
4708074,4708074,Snipe Lake No. 259,20,60,105,125,95,405,300
4708076,4708076,Eston,80,175,295,260,250,1060,548
4708092,4708092,Monet No. 257,40,75,125,140,65,445,155
4708094,4708094,Elrose,20,65,120,145,135,485,247
4709001,4709001,Calder No. 241,20,55,80,140,95,390,189
4709002,4709002,Calder,5,10,20,30,30,95,67
4709006,4709006,Wallace No. 243,45,170,215,275,155,860,399
4709009,4709009,Rhein,15,35,50,50,20,170,81
4709011,4709011,Orkney No. 244,90,360,500,665,245,1860,796
4709012,4709012,Yorkton,960,2950,4975,4080,3375,16340,7394
4709014,4709014,Ebenezer,10,35,65,60,15,185,79
4709016,4709016,Springside,40,90,160,135,90,515,236
4709019,4709019,Garry No. 245,20,70,95,110,65,360,146
4709023,4709023,Insinger No. 275,10,45,65,115,100,335,196
4709024,4709024,Sheho,5,5,30,30,35,105,88
4709028,4709028,Theodore,5,35,75,100,125,340,211
4709029,4709029,Good Lake No. 274,25,100,120,290,205,740,866
4709032,4709032,Canora,85,295,460,535,650,2025,1064
4709033,4709033,Sliding Hills No. 273,20,70,70,145,125,430,267
4709037,4709037,Cote No. 271,15,70,100,230,135,550,510
4709038,4709038,Togo,5,15,15,30,20,85,63
4709039,4709039,Kamsack,130,320,450,505,500,1905,976
4709042,4709042,St. Philips No. 301,10,40,30,70,70,220,152
4709044,4709044,Pelly,15,50,60,75,80,280,181
4709046,4709046,Keys No. 303,25,70,90,125,95,405,282
4709049,4709049,Buchanan No. 304,10,35,55,100,105,305,214
4709053,4709053,Buchanan,15,30,45,60,75,225,118
4709054,4709054,Invermay No. 305,10,75,65,120,75,345,156
4709056,4709056,Rama,5,5,30,20,25,85,48
4709058,4709058,Invermay,15,55,55,60,80,265,131
4709060,4709060,Hazel Dell No. 335,25,70,110,190,130,525,288
4709061,4709061,Lintlaw,20,30,50,30,35,165,89
4709062,4709062,Preeceville No. 334,50,190,185,310,190,925,499
4709064,4709064,Preeceville,40,175,260,255,390,1120,586
4709065,4709065,Endeavour,5,0,20,30,25,80,45
4709066,4709066,Sturgis,40,115,180,145,165,645,333
4709067,4709067,Clayton No. 333,40,100,135,185,135,595,305
4709069,4709069,Stenen,5,15,25,20,15,80,43
4709071,4709071,Hyas,0,10,10,20,30,70,49
4709072,4709072,Norquay,15,50,105,90,170,430,232
4709075,4709075,Livingston No. 331,15,40,75,95,70,295,143
4709076,4709076,Arran,0,0,0,0,0,0,25
4709819,4709819,Cote 64,90,260,220,125,50,745,269
4709820,4709820,Keeseekoose 66,55,180,140,95,25,495,155
4709821,4709821,The Key 65,20,45,40,35,5,145,58
4709822,4709822,Keeseekoose 66A,0,0,0,0,0,0,3
4709824,4709824,Keeseekoose 66-CA-04,0,0,0,0,0,0,1
4709826,4709826,Keeseekoose 66-CA-05,0,0,0,0,0,0,4
4709828,4709828,Keeseekoose 66-CA-06,0,0,0,0,0,0,1
4709830,4709830,Keeseekoose 66-KE-04,0,0,0,0,0,0,1
4709832,4709832,Keeseekoose 66-KE-05,0,0,0,0,0,0,2
4710002,4710002,Hubbard,0,0,0,0,0,0,16
4710003,4710003,Ituna Bon Accord No. 246,10,85,80,130,65,370,158
4710004,4710004,Ituna,35,105,165,155,245,705,368
4710008,4710008,Kellross No. 247,5,45,60,100,90,300,160
4710009,4710009,Kelliher,10,25,50,80,70,235,151
4710011,4710011,Leross,0,10,5,15,10,40,26
4710012,4710012,Lestock,5,15,10,25,40,95,98
4710014,4710014,Touchwood No. 248,20,80,90,115,45,350,147
4710022,4710022,Semans,10,25,40,70,60,205,137
4710024,4710024,Mount Hope No. 279,35,85,120,200,100,540,243
4710027,4710027,Raymore,25,95,135,170,140,565,295
4710028,4710028,Quinton,15,25,15,35,10,100,57
4710029,4710029,Punnichy,15,60,50,55,30,210,117
4710031,4710031,Emerald No. 277,5,50,55,160,140,410,258
4710034,4710034,Chorney Beach,0,0,0,0,0,0,59
4710035,4710035,Leslie Beach,0,0,0,0,0,0,21
4710036,4710036,Foam Lake No. 276,20,80,110,200,155,565,443
4710038,4710038,Foam Lake,50,165,275,300,355,1145,601
4710041,4710041,Elfros No. 307,20,65,85,145,75,390,198
4710043,4710043,Elfros,5,10,30,40,15,100,58
4710046,4710046,Big Quill No. 308,20,80,100,190,115,505,263
4710047,4710047,Wynyard,90,330,460,490,440,1810,928
4710051,4710051,Dafoe,0,0,0,0,0,0,10
4710052,4710052,Prairie Rose No. 309,10,45,50,85,45,235,91
4710054,4710054,Jansen,0,10,10,35,45,100,68
4710056,4710056,Leroy No. 339,25,100,135,170,75,505,209
4710058,4710058,Leroy,30,75,130,135,75,445,207
4710061,4710061,Lakeside No. 338,25,95,100,115,75,410,154
4710062,4710062,Watson,40,100,175,170,210,695,355
4710064,4710064,Quill Lake,15,60,90,100,130,395,228
4710066,4710066,Lakeview No. 337,30,60,95,115,75,375,174
4710068,4710068,Wadena,60,165,305,335,410,1275,661
4710071,4710071,Sasman No. 336,30,135,165,280,170,780,568
4710072,4710072,Margo,5,5,20,25,25,80,60
4710822,4710822,Muskowekwan 85,45,155,120,85,30,435,170
4710823,4710823,Gordon 86,105,290,245,150,45,835,238
4710824,4710824,Day Star 87,20,45,35,35,15,150,62
4710825,4710825,Poorman 88,90,275,200,130,35,730,196
4710826,4710826,Fishing Lake 89,35,145,115,75,35,405,161
4710828,4710828,Beardy's and Okemasis 96 and 97A,0,0,0,0,0,0,3
4710832,4710832,Muskowekwan 85-17,0,0,0,0,0,0,0
4710834,4710834,Muskowekwan 85-26,0,0,0,0,0,0,0
4710836,4710836,Muskowekwan 85-33,0,0,0,0,0,0,1
4710838,4710838,Muskowekwan 85-28,0,0,0,0,0,0,1
4710840,4710840,Muskowekwan 85-29,0,0,0,0,0,0,3
4710842,4710842,Muskowekwan 85-23,0,0,0,0,0,0,0
4710843,4710843,Muskowekwan 85-12,0,0,0,0,0,0,0
4710844,4710844,Muskowekwan 85-24,0,0,0,0,0,0,0
4710845,4710845,Muskowekwan 85-22,0,0,0,0,0,0,0
4710846,4710846,Muskowekwan 85-27,0,0,0,0,0,0,0
4710847,4710847,Muskowekwan 85-10,0,0,0,0,0,0,2
4710848,4710848,Muskowekwan 85-1,0,0,0,0,0,0,0
4710849,4710849,Muskowekwan 85-8,0,0,0,0,0,0,2
4710850,4710850,Muskowekwan 85-15,0,0,0,0,0,0,1
4710851,4710851,Muskowekwan 85-2A,0,0,0,0,0,0,0
4710852,4710852,Muskowekwan 85-31,0,0,0,0,0,0,0
4710854,4710854,Fishing Lake 89A,0,0,0,0,0,0,0
4711002,4711002,Duval,5,10,30,15,25,85,46
4711003,4711003,Last Mountain Valley No. 250,5,45,55,110,65,280,308
4711004,4711004,Govan,5,30,45,55,55,190,144
4711006,4711006,Big Arm No. 251,10,30,35,75,30,180,126
4711007,4711007,Etters Beach,0,0,0,0,0,0,114
4711008,4711008,Imperial,15,55,80,90,110,350,182
4711009,4711009,Liberty,10,5,25,25,20,85,50
4711011,4711011,Arm River No. 252,15,55,55,80,35,240,109
4711014,4711014,Davidson,65,175,305,250,260,1055,511
4711016,4711016,Willner No. 253,15,45,50,105,35,250,102
4711018,4711018,Loreburn No. 254,15,65,55,110,80,325,132
4711019,4711019,Elbow,10,40,70,125,105,350,243
4711021,4711021,Loreburn,0,20,25,35,25,105,55
4711022,4711022,Strongfield,0,5,15,5,10,35,20
4711024,4711024,Hawarden,5,5,10,25,15,60,36
4711026,4711026,Rudy No. 284,30,135,100,145,55,465,169
4711027,4711027,Outlook,170,360,600,545,610,2285,1069
4711028,4711028,Broderick,10,20,30,25,15,100,37
4711029,4711029,Glenside,5,30,15,15,10,75,23
4711031,4711031,Rosedale No. 283,40,120,145,160,60,525,153
4711032,4711032,Hanley,25,90,155,130,105,505,255
4711034,4711034,McCraney No. 282,15,55,75,115,45,305,133
4711036,4711036,Kenaston,15,55,75,95,35,275,131
4711038,4711038,Bladworth,0,15,20,20,5,60,38
4711039,4711039,Wood Creek No. 281,10,25,45,95,45,220,117
4711041,4711041,Simpson,10,15,35,40,35,135,87
4711042,4711042,Wreford No. 280,10,15,20,55,25,125,72
4711044,4711044,Nokomis,20,65,95,100,110,390,221
4711046,4711046,Usborne No. 310,30,105,130,170,95,530,216
4711048,4711048,Drake,10,35,55,65,35,200,102
4711049,4711049,Lanigan,80,280,360,345,310,1375,649
4711052,4711052,Morris No. 312,20,50,75,95,55,295,140
4711053,4711053,Watrous,105,335,485,495,485,1905,910
4711054,4711054,Manitou Beach,5,25,70,125,85,310,370
4711056,4711056,Young,15,40,65,75,35,230,133
4711058,4711058,Zelma,0,0,0,0,0,0,15
4711059,4711059,Lost River No. 313,20,55,70,65,35,245,79
4711060,4711060,Thode,5,30,40,55,5,135,101
4711061,4711061,Dundurn No. 314,190,510,1195,410,100,2405,503
4711063,4711063,Dundurn,45,135,200,165,60,605,262
4711064,4711064,Shields,25,45,90,90,45,295,195
4711065,4711065,Corman Park No. 344,425,1790,2095,3115,1150,8575,3037
4711066,4711066,Saskatoon,15630,43095,94045,60250,33365,246385,107098
4711067,4711067,Langham,145,280,535,360,190,1510,568
4711068,4711068,Warman,1130,2480,4510,2045,860,11025,3874
4711069,4711069,Blucher No. 343,135,375,560,680,265,2015,808
4711070,4711070,Martensville,995,2265,4090,1850,460,9660,3337
4711071,4711071,Bradwell,15,30,65,35,15,160,65
4711072,4711072,Allan,50,130,210,165,95,650,274
4711073,4711073,Dalmeny,145,435,590,455,200,1825,609
4711075,4711075,Osler,115,315,425,260,120,1235,412
4711076,4711076,Colonsay No. 342,10,35,70,110,50,275,121
4711077,4711077,Clavet,50,90,165,85,30,420,144
4711078,4711078,Meacham,5,15,25,25,20,90,55
4711079,4711079,Colonsay,30,95,135,120,70,450,207
4711091,4711091,Viscount No. 341,15,50,75,140,65,345,147
4711092,4711092,Viscount,10,40,50,70,20,190,129
4711094,4711094,Plunkett,5,0,10,20,20,55,36
4711096,4711096,Wolverine No. 340,35,90,120,165,70,480,187
4711828,4711828,Whitecap,35,145,160,85,20,445,166
4712001,4712001,Pleasant Valley No. 288,20,75,60,95,45,295,139
4712004,4712004,St. Andrews No. 287,45,115,140,155,70,525,179
4712006,4712006,Rosetown,120,390,655,625,660,2450,1187
4712008,4712008,Zealandia,5,15,25,25,20,90,42
4712011,4712011,Milden No. 286,15,65,95,95,55,325,114
4712012,4712012,Milden,5,25,35,55,55,175,112
4712014,4712014,Wiseton,10,0,15,30,20,75,48
4712016,4712016,Dinsmore,20,40,60,80,80,280,150
4712019,4712019,Macrorie,5,10,20,15,20,70,46
4712020,4712020,Fertile Valley No. 285,40,150,125,140,90,545,182
4712022,4712022,Conquest,10,45,30,45,30,160,78
4712026,4712026,Montrose No. 315,45,145,220,230,70,710,299
4712029,4712029,Harris No. 316,5,30,35,80,40,190,95
4712031,4712031,Tessier,0,0,0,0,0,0,15
4712032,4712032,Harris,5,25,45,65,45,185,120
4712034,4712034,Marriott No. 317,20,65,80,145,60,370,142
4712038,4712038,Mountain View No. 318,25,60,105,95,45,330,129
4712042,4712042,Biggar No. 347,65,150,200,255,130,800,307
4712046,4712046,Biggar,130,375,600,585,540,2230,1082
4712050,4712050,Perdue No. 346,40,95,135,135,40,445,156
4712051,4712051,Perdue,5,70,80,100,85,340,176
4712052,4712052,Kinley,5,5,15,20,5,50,29
4712054,4712054,Vanscoy No. 345,155,475,700,1135,375,2840,1221
4712056,4712056,Delisle,85,215,335,250,130,1015,438
4712058,4712058,Vanscoy,35,90,165,115,50,455,198
4712059,4712059,Asquith,45,150,235,140,65,635,261
4712064,4712064,Eagle Creek No. 376,50,125,170,155,100,600,163
4712069,4712069,Glenside No. 377,15,55,50,70,65,255,119
4712072,4712072,Rosemount No. 378,15,35,35,70,40,195,92
4712078,4712078,Battle River No. 438,55,235,275,395,175,1135,464
4712079,4712079,Battleford,310,850,1300,1175,795,4430,1816
4712829,4712829,Red Pheasant 108,65,165,160,105,20,515,163
4712830,4712830,Mosquito 109,60,160,165,85,5,475,113
4712832,4712832,Grizzly Bear's Head 110 and Lean Man 111,10,30,15,0,0,55,19
4712833,4712833,Sweet Grass 113,65,200,200,120,50,635,181
4712837,4712837,Sweet Grass 113-M16,0,0,0,0,0,0,1
4713002,4713002,Brock,15,20,60,35,15,145,63
4713004,4713004,Netherhill,0,0,0,0,0,0,14
4713006,4713006,Kindersley No. 290,60,220,315,345,105,1045,401
4713008,4713008,Kindersley,255,795,1610,1190,725,4575,2063
4713009,4713009,Flaxcombe,15,20,50,30,10,125,51
4713011,4713011,Milton No. 292,10,30,60,90,35,225,162
4713014,4713014,Marengo,15,35,45,40,15,150,74
4713016,4713016,Antelope Park No. 322,10,20,25,50,30,135,61
4713019,4713019,Prairiedale No. 321,15,70,65,65,35,250,65
4713021,4713021,Major,0,0,0,0,0,0,26
4713022,4713022,Smiley,0,10,10,25,5,50,37
4713024,4713024,Oakdale No. 320,10,50,70,90,45,265,114
4713026,4713026,Coleville,25,45,120,80,40,310,163
4713028,4713028,Winslow No. 319,25,90,105,85,50,355,137
4713029,4713029,Dodsland,15,45,65,45,35,205,111
4713031,4713031,Plenty,10,30,65,30,20,155,79
4713032,4713032,Grandview No. 349,20,60,90,125,45,340,116
4713038,4713038,Mariposa No. 350,5,40,45,80,25,195,98
4713039,4713039,Tramping Lake,0,10,15,20,10,55,44
4713041,4713041,Progress No. 351,10,45,60,100,40,255,135
4713042,4713042,Kerrobert,50,210,280,275,205,1020,497
4713044,4713044,Luseland,40,105,190,165,130,630,314
4713046,4713046,Heart's Hill No. 352,20,55,50,75,45,245,112
4713049,4713049,Eye Hill No. 382,35,130,145,210,65,585,266
4713051,4713051,Macklin,105,310,460,315,190,1380,563
4713053,4713053,Primate,0,15,15,15,0,45,24
4713054,4713054,Denzil,5,35,50,25,15,130,73
4713056,4713056,Grass Lake No. 381,30,65,90,140,70,395,207
4713059,4713059,Tramping Lake No. 380,25,95,100,115,50,385,96
4713062,4713062,Scott,5,5,20,30,25,85,51
4713064,4713064,Reford No. 379,15,40,55,85,50,245,119
4713067,4713067,Landis,15,15,35,45,40,150,82
4713068,4713068,Buffalo No. 409,20,100,115,200,70,505,204
4713069,4713069,Wilkie,80,185,300,360,295,1220,581
4713072,4713072,Round Valley No. 410,25,85,100,120,70,400,176
4713074,4713074,Unity,165,520,755,590,535,2565,1170
4713076,4713076,Senlac No. 411,20,20,40,75,40,195,155
4713078,4713078,Senlac,5,0,5,15,25,50,31
4713079,4713079,Manitou Lake No. 442,35,125,150,185,80,575,236
4713091,4713091,Marsden,20,70,100,65,35,290,132
4713092,4713092,Hillsdale No. 440,30,130,160,140,75,535,178
4713094,4713094,Neilburg,30,65,140,85,60,380,175
4713096,4713096,Cut Knife No. 439,20,45,75,160,65,365,370
4713098,4713098,Cut Knife,45,115,150,145,120,575,263
4713835,4713835,Poundmaker 114,70,170,165,105,30,540,201
4713836,4713836,Little Pine 116,90,210,220,125,45,690,220
4714001,4714001,Hudson Bay No. 394,45,185,245,390,245,1110,852
4714004,4714004,Hudson Bay,65,205,330,445,350,1395,779
4714006,4714006,Porcupine No. 395,30,110,160,260,235,795,471
4714007,4714007,Porcupine Plain,55,155,230,185,235,860,392
4714009,4714009,Weekes,0,5,0,15,15,35,57
4714021,4714021,Kelvington No. 366,25,40,85,160,90,400,237
4714022,4714022,Kelvington,35,105,175,240,300,855,478
4714023,4714023,Ponass Lake No. 367,20,65,75,140,125,425,238
4714024,4714024,Rose Valley,15,50,65,80,85,295,166
4714025,4714025,Fosston,0,10,5,20,10,45,35
4714026,4714026,Spalding No. 368,25,75,120,150,80,450,230
4714028,4714028,Spalding,15,50,55,65,60,245,152
4714030,4714030,Pleasantdale,5,15,15,25,15,75,37
4714032,4714032,Naicam,20,120,165,175,180,660,354
4714034,4714034,Barrier Valley No. 397,20,50,115,140,100,425,308
4714035,4714035,Pleasantdale No. 398,25,75,140,225,125,590,471
4714036,4714036,Archerwill,10,30,30,50,40,160,104
4714038,4714038,Bjorkdale No. 426,35,120,160,280,245,840,1046
4714039,4714039,Mistatim,5,15,5,30,30,85,48
4714041,4714041,Bjorkdale,15,35,55,65,35,205,101
4714043,4714043,Tisdale No. 427,40,190,245,315,135,925,365
4714044,4714044,Tisdale,165,545,885,725,925,3245,1637
4714047,4714047,Star City No. 428,40,205,195,320,170,930,331
4714048,4714048,Valparaiso,0,0,0,0,0,0,11
4714049,4714049,Star City,25,65,90,105,105,390,201
4714051,4714051,Melfort,355,1190,1700,1425,1330,6000,2691
4714053,4714053,Willow Creek No. 458,25,85,145,220,140,615,318
4714056,4714056,Connaught No. 457,30,105,145,210,100,590,253
4714058,4714058,Ridgedale,0,5,15,15,15,50,41
4714059,4714059,Arborfield No. 456,15,60,75,120,75,345,165
4714061,4714061,Zenon Park,10,40,50,60,20,180,88
4714062,4714062,Arborfield,15,30,70,85,95,295,146
4714067,4714067,Moose Range No. 486,65,200,260,295,180,1000,417
4714068,4714068,Tobin Lake,0,15,15,40,20,90,142
4714069,4714069,Carrot River,60,145,245,290,250,990,467
4714072,4714072,Nipawin No. 487,50,190,240,320,210,1010,440
4714073,4714073,Aylsham,0,10,15,25,15,65,44
4714074,4714074,Codette,0,25,50,75,55,205,105
4714076,4714076,Nipawin,305,795,1200,1055,1040,4395,2042
4714077,4714077,Torch River No. 488,55,230,305,520,365,1475,740
4714079,4714079,White Fox,20,60,80,120,80,360,184
4714091,4714091,Love,0,0,10,15,15,40,30
4714092,4714092,Choiceland,10,70,100,90,85,355,204
4714093,4714093,Smeaton,10,25,40,35,75,185,90
4714839,4714839,Shoal Lake 28A,35,125,145,105,5,415,118
4714840,4714840,Red Earth 29,50,130,100,50,5,335,82
4714841,4714841,Yellowquill 90,60,165,115,75,15,430,121
4714842,4714842,Kinistin 91,50,110,105,40,5,310,90
4714843,4714843,Yellow Quill 90-9,0,20,15,10,5,50,15
4714845,4714845,Carrot River 29A,155,330,245,90,5,825,127
4714846,4714846,Opaskwayak Cree Nation 27A (Carrot River),0,0,0,0,0,0,0
4715001,4715001,St. Peter No. 369,40,180,195,235,135,785,300
4715002,4715002,Englefeld,15,80,85,75,40,295,117
4715003,4715003,St. Gregor,5,15,30,20,20,90,48
4715004,4715004,Muenster,20,85,140,115,80,440,184
4715005,4715005,Annaheim,10,45,60,60,30,205,94
4715006,4715006,Lake Lenore,15,65,100,65,30,275,128
4715007,4715007,Humboldt No. 370,65,185,235,330,130,945,432
4715008,4715008,Humboldt,335,1030,1605,1435,1450,5855,2582
4715011,4715011,Bayne No. 371,40,80,115,170,70,475,206
4715012,4715012,Bruno,35,100,135,175,145,590,286
4715014,4715014,Grant No. 372,40,100,125,125,75,465,187
4715016,4715016,Prud'Homme,15,25,50,45,25,160,78
4715017,4715017,Vonda,30,95,125,90,40,380,155
4715018,4715018,Aberdeen No. 373,125,290,440,420,105,1380,558
4715019,4715019,Aberdeen,55,130,240,125,60,610,254
4715026,4715026,Laird No. 404,100,400,395,360,110,1365,415
4715027,4715027,Hepburn,70,170,235,160,55,690,246
4715028,4715028,Waldheim,125,275,355,280,180,1215,424
4715029,4715029,Laird,15,45,75,95,40,270,118
4715031,4715031,Rosthern No. 403,220,545,700,545,305,2315,707
4715032,4715032,Rosthern,100,350,410,400,420,1680,747
4715034,4715034,Hague,70,195,330,190,95,880,339
4715036,4715036,Fish Creek No. 402,20,65,75,130,50,340,167
4715038,4715038,Alvena,5,10,15,15,5,50,46
4715039,4715039,Hoodoo No. 401,25,100,110,270,165,670,802
4715041,4715041,Cudworth,45,140,185,190,245,805,361
4715042,4715042,Wakaw,50,150,205,230,285,920,489
4715043,4715043,Wakaw Lake,0,10,5,30,20,65,108
4715044,4715044,Three Lakes No. 400,25,110,110,180,185,610,340
4715045,4715045,Pilger,5,0,5,30,30,70,46
4715046,4715046,St. Benedict,5,0,20,30,15,70,53
4715047,4715047,Middle Lake,5,40,55,70,60,230,125
4715048,4715048,Lake Lenore No. 399,45,130,150,195,85,605,290
4715049,4715049,St. Brieux,40,180,215,135,110,680,247
4715051,4715051,Flett's Springs No. 429,30,170,200,210,130,740,274
4715052,4715052,Beatty,5,10,15,10,15,55,25
4715054,4715054,Invergordon No. 430,25,70,100,225,150,570,395
4715057,4715057,St. Louis No. 431,60,185,275,355,190,1065,452
4715059,4715059,St. Louis,30,95,100,110,75,410,155
4715061,4715061,Duck Lake No. 463,70,205,260,330,135,1000,395
4715062,4715062,Duck Lake,40,135,135,140,125,575,242
4715064,4715064,Prince Albert No. 461,135,590,1250,1100,495,3570,1122
4715066,4715066,Prince Albert,2570,7695,11755,8440,5470,35930,15173
4715067,4715067,Birch Hills No. 460,35,150,165,195,130,675,263
4715068,4715068,Birch Hills,75,190,300,240,220,1025,465
4715070,4715070,Candle Lake,10,70,85,365,310,840,1665
4715071,4715071,Kinistino No. 459,25,120,125,155,115,540,231
4715072,4715072,Weldon,5,30,35,45,80,195,93
4715074,4715074,Kinistino,40,120,160,155,185,660,304
4715075,4715075,Lakeland No. 521,20,75,115,350,360,920,2134
4715076,4715076,Christopher Lake,25,60,65,85,50,285,138
4715079,4715079,Garden River No. 490,50,130,195,230,110,715,304
4715085,4715085,Albertville,5,15,35,20,15,90,35
4715091,4715091,Weirdale,0,15,10,30,5,60,27
4715092,4715092,Meath Park,10,45,60,30,40,185,82
4715094,4715094,Buckland No. 491,130,690,855,1150,545,3370,1311
4715098,4715098,Paddockwood,10,40,35,30,25,140,70
4715099,4715099,Paddockwood No. 520,40,120,195,355,180,890,479
4715844,4715844,One Arrow 95,100,240,225,105,20,690,168
4715845,4715845,Beardy's 97 and Okemasis 96,135,405,455,255,75,1325,311
4715847,4715847,Muskoday First Nation,55,170,205,140,75,645,217
4715848,4715848,Wahpaton 94A,40,130,85,55,20,330,80
4715849,4715849,James Smith 100,75,265,245,135,30,750,152
4715850,4715850,Cumberland 100A,30,90,95,70,25,310,82
4715851,4715851,Little Red River 106C,45,125,100,65,5,340,98
4715853,4715853,Montreal Lake 106B,65,145,140,70,25,445,118
4715857,4715857,One Arrow 95-1C,0,0,0,0,0,0,4
4715859,4715859,Beardy's and Okemasis 96 and 97B,0,0,0,0,0,0,5
4715861,4715861,One Arrow 95-1D,0,0,0,0,0,0,1
4715862,4715862,One Arrow 95-1A,0,0,0,0,0,0,2
4716002,4716002,Denholm,5,20,25,20,10,80,36
4716003,4716003,Ruddell,0,0,0,0,0,0,15
4716004,4716004,Maymont,10,15,30,45,35,135,78
4716005,4716005,Mayfield No. 406,30,60,95,130,70,385,172
4716008,4716008,Great Bend No. 405,25,85,130,175,90,505,232
4716009,4716009,Radisson,30,75,135,150,115,505,268
4716011,4716011,Borden,15,40,85,60,85,285,140
4716013,4716013,Blaine Lake No. 434,20,50,55,115,50,290,128
4716014,4716014,Marcelin,5,30,30,55,30,150,90
4716016,4716016,Blaine Lake,20,105,100,155,130,510,309
4716018,4716018,Redberry No. 435,5,65,55,125,95,345,181
4716019,4716019,Krydor,0,0,0,0,0,0,24
4716022,4716022,Hafford,15,75,85,110,135,420,220
4716023,4716023,Douglas No. 436,20,55,80,115,80,350,173
4716024,4716024,Speers,0,5,10,25,25,65,34
4716026,4716026,Richard,0,0,0,0,0,0,10
4716027,4716027,North Battleford,0,0,0,0,0,0,1
4716028,4716028,North Battleford No. 437,35,140,170,255,135,735,290
4716029,4716029,North Battleford,1065,2800,4585,3375,2485,14310,6413
4716033,4716033,Round Hill No. 467,20,55,60,130,90,355,189
4716038,4716038,Meeting Lake No. 466,20,60,60,105,75,320,220
4716041,4716041,Leask No. 464,30,110,140,235,175,690,704
4716042,4716042,Leask,15,60,65,120,145,405,211
4716043,4716043,Pebble Baye,5,0,0,5,20,30,113
4716044,4716044,Parkside,10,30,30,35,25,130,72
4716046,4716046,Shellbrook No. 493,85,305,400,545,275,1610,764
4716047,4716047,Shellbrook,65,250,370,380,370,1435,700
4716051,4716051,Canwood No. 494,70,255,280,485,285,1375,777
4716052,4716052,Canwood,15,40,50,85,125,315,176
4716053,4716053,Prince Albert National Park,5,15,30,60,55,165,636
4716054,4716054,Debden,25,70,80,85,90,350,148
4716056,4716056,Spiritwood No. 496,55,285,280,470,260,1350,786
4716057,4716057,Shell Lake,10,20,35,50,85,200,231
4716058,4716058,Spiritwood,55,125,210,165,230,785,373
4716059,4716059,Big Shell,0,5,0,25,25,55,111
4716060,4716060,Echo Bay,0,0,5,15,10,30,143
4716061,4716061,Leoville,25,80,90,95,90,380,162
4716062,4716062,Medstead No. 497,30,90,110,170,110,510,237
4716063,4716063,Medstead,5,30,30,30,25,120,72
4716072,4716072,Big River,50,125,210,175,125,685,331
4716075,4716075,Big River No. 555,50,140,215,320,170,895,656
4716077,4716077,Chitek Lake,0,10,30,55,40,135,291
4716854,4716854,Muskeg Lake Cree Nation 102,20,75,70,70,25,260,112
4716855,4716855,Mistawasis 103,65,235,185,145,45,675,180
4716856,4716856,Sturgeon Lake 101,135,390,420,185,45,1175,293
4716857,4716857,Little Red River 106D,0,0,0,0,0,0,3
4716858,4716858,Big River 118,185,590,480,250,50,1555,407
4716860,4716860,Ahtahkakoop 104,160,525,450,275,80,1490,424
4716861,4716861,Saulteaux 159A,0,0,0,0,0,0,10
4716862,4716862,Witchekan Lake 117,40,125,100,55,10,330,80
4716863,4716863,Chitek Lake 191,125,275,285,105,30,820,300
4716870,4716870,Lucky Man,0,0,0,0,0,0,0
4716872,4716872,Muskeg Lake 102B,0,0,0,0,0,0,0
4716880,4716880,Pelican Lake 191B,5,20,5,5,0,35,19
4716882,4716882,Witchekan Lake 117D,0,0,0,0,0,0,3
4716886,4716886,Muskeg Lake 102E,0,0,0,0,0,0,0
4716888,4716888,Muskeg Lake 102F,0,0,0,0,0,0,8
4716890,4716890,Muskeg Lake 102G,0,0,0,0,0,0,0
4716891,4716891,Muskeg Lake 102D,0,0,0,0,0,0,0
4716892,4716892,Sweet Grass 113-L6,0,0,0,0,0,0,0
4716894,4716894,Pelican Lake 191A,0,0,0,0,0,0,6
4717001,4717001,Meota No. 468,35,145,180,345,230,935,837
4717002,4717002,Cochin,0,5,5,60,65,135,442
4717004,4717004,Metinota,0,5,10,30,35,80,57
4717005,4717005,Aquadeo,0,0,10,40,50,100,387
4717006,4717006,Meota,15,25,65,100,100,305,208
4717008,4717008,Turtle River No. 469,25,75,85,110,50,345,150
4717011,4717011,Edam,45,110,145,85,90,475,210
4717013,4717013,Paynton No. 470,15,45,70,90,30,250,135
4717014,4717014,Paynton,5,35,45,55,15,155,86
4717017,4717017,Eldon No. 471,60,165,225,215,95,760,314
4717018,4717018,Maidstone,95,245,385,265,185,1175,525
4717019,4717019,Waseca,10,25,55,45,10,145,75
4717022,4717022,Wilton No. 472,130,350,495,455,205,1635,646
4717024,4717024,Lashburn,85,225,395,195,90,990,386
4717026,4717026,Marshall,60,120,210,135,40,565,221
4717028,4717028,Britannia No. 502,155,525,745,535,195,2155,836
4717029,4717029,Lloydminster (Part),1025,2490,5490,2100,655,11760,4909
4717032,4717032,Frenchman Butte No. 501,85,380,415,390,230,1500,544
4717034,4717034,Paradise Hill,30,100,135,125,90,480,239
4717036,4717036,St. Walburg,40,125,215,145,165,690,326
4717039,4717039,Mervin,10,20,50,45,40,165,94
4717041,4717041,Turtleford,30,90,155,135,85,495,248
4717042,4717042,Kivimaa-Moonlight Bay,0,0,0,25,45,70,238
4717045,4717045,Mervin No. 499,50,140,215,465,370,1240,1607
4717047,4717047,Parkdale No. 498,25,100,140,225,140,630,741
4717048,4717048,Glaslyn,35,70,110,95,75,385,179
4717052,4717052,Meadow Lake,485,1285,1870,1135,575,5350,2113
4717053,4717053,Greig Lake,0,0,0,0,0,0,89
4717054,4717054,Meadow Lake No. 588,130,475,655,845,405,2510,1239
4717055,4717055,Dorintosh,15,10,30,30,30,115,74
4717056,4717056,Loon Lake No. 561,30,140,155,260,175,760,638
4717057,4717057,Makwa,5,5,20,40,20,90,43
4717058,4717058,Loon Lake,25,55,70,65,80,295,158
4717062,4717062,Beaver River No. 622,65,270,320,355,205,1215,841
4717066,4717066,Goodsoil,25,40,70,70,60,265,156
4717067,4717067,Pierceland,40,130,220,135,80,605,289
4717801,4717801,Seekaskootch 119,290,950,830,380,115,2565,639
4717802,4717802,Makaoo (Part) 120,50,180,185,70,25,510,130
4717803,4717803,Thunderchild First Nation 115B,60,245,200,155,35,695,200
4717804,4717804,Thunderchild First Nation 115C,0,0,0,0,0,0,16
4717805,4717805,Flying Dust First Nation 105 (Meadow Lake 105),45,205,165,120,40,575,187
4717806,4717806,Waterhen 130,90,235,200,100,45,670,213
4717807,4717807,Makwa Lake 129B,130,365,320,145,15,975,444
4717808,4717808,Makwa Lake 129,0,0,0,0,0,0,5
4717809,4717809,Ministikwan 161,85,230,205,85,25,630,150
4717810,4717810,Ministikwan 161A,30,95,50,40,5,220,42
4717811,4717811,Big Island Lake Cree Territory,115,300,280,100,15,810,165
4717812,4717812,Moosomin 112B,90,270,205,110,25,700,195
4717813,4717813,Saulteaux 159,65,160,150,80,20,475,142
4717815,4717815,Makwa Lake 129C,0,0,0,0,0,0,5
4717816,4717816,Eagles Lake 165C,10,30,20,25,5,90,32
4717819,4717819,Meadow Lake 105A,0,0,0,0,0,0,1
4717820,4717820,Onion Lake 119-1,0,0,0,0,0,0,0
4717825,4717825,Min-A-He-Quo-Sis 116C,0,0,0,0,0,0,0
4718005,4718005,Cumberland House,75,195,215,150,45,680,228
4718012,4718012,Timber Bay,10,25,25,20,0,80,33
4718015,4718015,Weyakwin,0,15,25,10,0,50,41
4718021,4718021,Green Lake,45,110,105,120,45,425,225
4718023,4718023,Dore Lake,0,0,0,0,0,0,107
4718028,4718028,Cole Bay,15,50,55,35,10,165,66
4718030,4718030,Jans Bay,25,50,50,20,5,150,44
4718033,4718033,Beauval,55,165,200,160,70,650,293
4718041,4718041,La Ronge,260,635,995,605,195,2690,1135
4718042,4718042,Air Ronge,100,285,405,250,65,1105,413
4718049,4718049,Denare Beach,45,170,200,255,110,780,432
4718051,4718051,Creighton,65,310,380,425,220,1400,600
4718052,4718052,Flin Flon (Part),5,40,50,75,35,205,84
4718055,4718055,Pelican Narrows,80,220,225,75,40,640,167
4718058,4718058,Sandy Bay,85,290,175,105,45,700,209
4718062,4718062,Missinipe,0,0,0,0,0,0,23
4718065,4718065,Pinehouse,95,355,350,190,60,1050,283
4718067,4718067,Île-à-la-Crosse,125,335,425,290,120,1295,450
4718069,4718069,Patuanak,10,20,15,15,10,70,32
4718070,4718070,Buffalo Narrows,100,290,330,270,115,1105,430
4718071,4718071,St. George's Hill,0,0,0,0,0,0,58
4718072,4718072,Michel Village,0,10,10,25,10,55,31
4718074,4718074,La Loche,275,740,835,410,115,2375,752
4718075,4718075,Turnor Lake,15,55,45,30,10,155,60
4718090,4718090,"Division No. 18, Unorganized",60,125,240,430,260,1115,1395
4718100,4718100,Stony Rapids,15,70,100,70,25,280,130
4718801,4718801,Cumberland House Cree Nation 20,105,270,275,140,30,820,235
4718802,4718802,Montreal Lake 106,145,360,385,190,35,1115,277
4718803,4718803,Stanley 157,210,605,670,275,90,1850,466
4718806,4718806,Wapaskokimaw 202,65,190,150,60,15,480,105
4718807,4718807,La Plonge 192,15,45,40,35,15,150,51
4718808,4718808,Morin Lake 217,75,185,200,75,35,570,155
4718809,4718809,Lac La Ronge 156,240,675,715,300,70,2000,480
4718811,4718811,Sucker River 156C (Nemebien River 156C),55,125,150,75,25,430,124
4718812,4718812,Kitsakie 156B,65,145,215,130,45,600,151
4718813,4718813,Four Portages 157C,0,0,0,0,0,0,0
4718814,4718814,Wapachewunak 192D,35,155,190,110,65,555,199
4718817,4718817,Canoe Lake 165,100,315,275,165,55,910,273
4718818,4718818,Buffalo River Dene Nation 193 (Peter Pond Lake 193),80,230,260,170,50,790,260
4718819,4718819,Turnor Lake 193B,50,135,195,70,35,485,146
4718820,4718820,Pelican Narrows 184B,270,670,640,230,55,1865,350
4718821,4718821,Sturgeon Weir 184F,5,30,20,25,5,85,26
4718822,4718822,Southend 200,110,320,315,130,45,920,206
4718823,4718823,Chicken 225,0,0,0,0,0,0,0
4718824,4718824,Fond du Lac 227,90,300,335,135,45,905,231
4718825,4718825,Brabant Lake,10,15,25,5,5,60,26
4718826,4718826,Southend No. 200A,10,50,40,20,5,125,37
4718828,4718828,Chicken 224,120,480,530,180,60,1370,280
4718829,4718829,Clearwater River Dene Band 223,0,0,0,0,0,0,11
4718831,4718831,Grandmother's Bay 219,40,105,125,60,5,335,115
4718832,4718832,Lac La Hache 220,140,470,535,170,55,1370,282
4718839,4718839,Clearwater River Dene 222,95,245,330,120,30,820,218
4718844,4718844,Little Hills 158,0,0,0,0,0,0,0
4718849,4718849,Little Hills 158B,0,0,0,0,0,0,0
4718852,4718852,Kimosom Pwatinahk 203 (Deschambault Lake),160,360,365,145,45,1075,221
4718854,4718854,Kinoosao-Thomas Clark 204,0,0,0,0,0,0,18
4801003,4801003,Cypress County,490,1725,2205,2420,820,7660,3222
4801006,4801006,Medicine Hat,3655,11105,20160,17110,11230,63260,27970
4801008,4801008,Forty Mile County No. 8,355,950,1025,860,390,3580,968
4801009,4801009,Foremost,40,100,130,160,105,535,257
4801014,4801014,Bow Island,210,480,565,420,325,2000,682
4801018,4801018,Redcliff,365,1190,1875,1520,660,5610,2232
4802001,4802001,Warner County No. 5,325,950,1065,1000,500,3840,941
4802002,4802002,Coutts,10,35,40,90,70,245,159
4802004,4802004,Milk River,25,115,165,230,290,825,420
4802006,4802006,Warner,20,50,80,105,115,370,196
4802008,4802008,Raymond,315,995,1030,785,585,3710,1259
4802009,4802009,Stirling,80,295,255,215,130,975,375
4802011,4802011,Lethbridge County,880,2825,2980,2575,1100,10360,3129
4802012,4802012,Lethbridge,5625,15805,33500,22625,15170,92725,39867
4802013,4802013,Coalhurst,260,575,1025,560,245,2665,970
4802014,4802014,Nobleford,165,335,425,225,115,1265,427
4802016,4802016,Barons,35,55,90,90,45,315,148
4802018,4802018,Picture Butte,155,390,580,375,315,1815,706
4802019,4802019,Coaldale,680,1700,2585,1975,1285,8225,3070
4802021,4802021,Taber,730,2190,2060,1505,610,7095,2081
4802022,4802022,Taber,620,1850,2675,2010,1275,8430,3384
4802023,4802023,Barnwell,115,300,295,150,65,925,266
4802029,4802029,Vauxhall,130,345,330,275,145,1225,458
4802031,4802031,Newell County,520,1805,2150,2165,870,7510,2627
4802034,4802034,Brooks,1170,3080,5530,3130,1550,14460,5412
4802036,4802036,Duchess,95,275,395,235,80,1080,390
4802038,4802038,Rosemary,40,95,125,85,50,395,150
4802039,4802039,Bassano,55,190,275,380,310,1210,556
4803001,4803001,Cardston County,365,1105,1210,1125,675,4480,1260
4803002,4803002,Magrath,170,645,625,515,415,2370,794
4803003,4803003,Improvement District No. 4 Waterton,5,5,30,25,25,90,168
4803004,4803004,Cardston,245,855,815,745,915,3575,1270
4803006,4803006,Glenwood,25,105,75,55,60,320,119
4803008,4803008,Hill Spring,10,20,25,45,55,155,92
4803011,4803011,Pincher Creek No. 9,165,510,675,945,670,2965,1640
4803014,4803014,Pincher Creek,195,625,980,955,900,3655,1589
4803016,4803016,Cowley,10,30,45,70,45,200,113
4803018,4803018,Willow Creek No. 26,330,1130,1340,1525,845,5170,1863
4803019,4803019,Fort Macleod,195,505,775,815,670,2960,1426
4803021,4803021,Granum,10,45,85,160,100,400,206
4803022,4803022,Claresholm,145,505,830,1080,1235,3795,1742
4803024,4803024,Stavely,30,70,120,180,140,540,290
4803026,4803026,Nanton,110,285,480,610,630,2115,959
4803801,4803801,Piikani 147,135,395,515,350,135,1530,438
4803802,4803802,Blood 148,395,1285,1410,1075,395,4560,1436
4803803,4803803,Blood 148A,0,0,0,0,0,0,0
4804001,4804001,Acadia No. 34,30,105,135,145,85,500,184
4804004,4804004,Special Area No. 2,140,380,530,565,295,1910,750
4804006,4804006,Empress,10,25,25,50,40,150,71
4804011,4804011,Hanna,120,400,705,760,570,2555,1246
4804012,4804012,Special Area No. 3,80,200,250,340,155,1025,457
4804014,4804014,Oyen,50,145,250,255,295,995,422
4804016,4804016,Cereal,5,5,20,45,40,115,63
4804019,4804019,Youngstown,10,20,35,55,30,150,88
4804020,4804020,Special Area No. 4,75,310,355,355,145,1240,471
4804021,4804021,Veteran,10,35,60,55,40,200,112
4804022,4804022,Consort,55,115,225,175,165,735,310
4805001,4805001,Vulcan County,315,885,1070,1140,560,3970,1616
4805002,4805002,Carmangay,5,25,35,85,85,235,135
4805004,4805004,Champion,15,40,65,95,95,310,185
4805006,4805006,Vulcan,80,265,395,545,625,1910,879
4805008,4805008,Lomond,15,30,45,40,40,170,101
4805009,4805009,Milo,0,10,20,35,25,90,64
4805011,4805011,Arrowwood,20,50,55,45,35,205,79
4805012,4805012,Wheatland County,530,1825,2470,2845,1135,8805,3117
4805018,4805018,Strathmore,905,2765,4495,3425,2155,13745,5358
4805019,4805019,Hussar,15,40,55,55,20,185,87
4805021,4805021,Standard,15,75,90,115,55,350,150
4805022,4805022,Rockyford,15,50,90,105,60,320,151
4805026,4805026,Drumheller,395,1230,2660,2295,1395,7975,3471
4805031,4805031,Starland County,140,465,550,570,340,2065,693
4805034,4805034,Delia,10,40,55,55,55,215,115
4805036,4805036,Munson,10,40,65,70,15,200,89
4805038,4805038,Morrin,10,45,60,70,55,240,132
4805041,4805041,Kneehill County,305,1005,1345,1590,755,5000,1859
4805042,4805042,Carbon,20,85,110,145,90,450,222
4805044,4805044,Acme,40,120,175,235,90,660,301
4805046,4805046,Linden,40,135,205,210,235,825,331
4805048,4805048,Three Hills,195,640,885,730,765,3215,1306
4805049,4805049,Trochu,60,195,275,290,240,1060,472
4805802,4805802,Siksika 146,340,1055,1120,695,255,3465,1131
4806001,4806001,Foothills No. 31,940,4360,5490,8555,3425,22770,8689
4806006,4806006,High River,745,2565,3880,3410,2960,13560,5655
4806008,4806008,Longview,10,40,80,115,80,325,151
4806009,4806009,Turner Valley,165,460,775,745,430,2575,1066
4806011,4806011,Black Diamond,160,415,740,775,605,2695,1108
4806012,4806012,Okotoks,1890,7220,9540,7240,2995,28885,9840
4806014,4806014,Rocky View County,1735,8670,10085,13600,5330,39420,13620
4806016,4806016,Calgary,77985,218725,482030,322085,138395,1239220,489650
4806017,4806017,Chestermere,1545,4575,7240,5120,1405,19885,6250
4806019,4806019,Cochrane,1975,4925,9255,6710,2985,25850,10225
4806021,4806021,Airdrie,5460,13410,25140,13410,4155,61575,22398
4806022,4806022,Irricana,70,240,385,400,110,1205,479
4806024,4806024,Beiseker,45,170,240,265,120,840,338
4806026,4806026,Crossfield,185,615,940,840,385,2965,1168
4806028,4806028,Mountain View County,680,2425,3390,4530,2035,13060,5666
4806029,4806029,Carstairs,290,830,1315,1085,550,4070,1590
4806031,4806031,Cremona,35,70,140,120,65,430,204
4806032,4806032,Didsbury,290,975,1505,1425,1080,5275,2119
4806034,4806034,Olds,490,1570,2890,2255,1985,9190,3942
4806036,4806036,Sundre,145,465,765,715,640,2730,1256
4806803,4806803,Eden Valley 216,85,180,230,85,20,600,113
4806804,4806804,Tsuu T'ina Nation 145 (Sarcee 145),110,490,450,475,115,1640,742
4807001,4807001,Provost No. 52,125,455,595,725,300,2200,930
4807002,4807002,Provost,120,440,660,460,315,1995,843
4807004,4807004,Czar,10,40,65,55,35,205,87
4807006,4807006,Hughenden,10,50,80,60,35,235,117
4807008,4807008,Amisk,15,35,65,65,35,215,103
4807011,4807011,Paintearth County No. 18,135,520,515,660,260,2090,696
4807012,4807012,Coronation,55,165,260,280,185,945,442
4807014,4807014,Castor,35,130,205,235,310,915,448
4807016,4807016,Halkirk,10,15,30,35,30,120,56
4807019,4807019,Stettler County No. 6,370,1070,1485,1665,735,5325,2137
4807021,4807021,Big Valley,20,45,85,105,105,360,189
4807022,4807022,Gadsby,5,5,20,10,5,45,25
4807024,4807024,Botha,15,50,50,75,20,210,81
4807026,4807026,Stettler,385,1005,1825,1400,1330,5945,2607
4807027,4807027,White Sands,0,15,10,65,35,125,253
4807028,4807028,Rochon Sands,0,5,20,30,40,95,152
4807029,4807029,Donalda,10,35,50,75,55,225,131
4807031,4807031,Flagstaff County,195,735,935,1195,670,3730,1532
4807032,4807032,Alliance,5,10,35,60,55,165,107
4807036,4807036,Forestburg,35,170,220,260,185,870,404
4807038,4807038,Heisler,10,10,30,60,55,165,87
4807039,4807039,Daysland,35,120,200,210,250,815,356
4807042,4807042,Killam,65,210,290,200,210,975,415
4807044,4807044,Sedgewick,50,145,240,225,150,810,401
4807046,4807046,Lougheed,25,50,80,55,50,260,118
4807048,4807048,Hardisty,25,85,160,170,110,550,401
4807049,4807049,Wainwright No. 61,305,1020,1430,1290,450,4495,1768
4807051,4807051,Chauvin,20,55,100,95,55,325,156
4807052,4807052,Edgerton,30,55,120,110,55,370,192
4807054,4807054,Wainwright,390,1135,2250,1545,955,6275,2770
4807056,4807056,Irma,40,85,165,135,100,525,242
4808001,4808001,Red Deer County,990,3540,5745,6505,2745,19525,8440
4808002,4808002,Elnora,15,45,70,85,90,305,160
4808004,4808004,Delburne,60,170,265,265,115,875,394
4808005,4808005,Jarvis Bay,5,40,45,105,25,220,136
4808006,4808006,Bowden,85,225,405,315,210,1240,581
4808008,4808008,Innisfail,430,1485,2205,2100,1635,7855,3509
4808009,4808009,Penhold,325,645,1415,700,195,3280,1300
4808011,4808011,Red Deer,6365,18350,38245,25445,12015,100420,42285
4808012,4808012,Sylvan Lake,1190,3150,5915,3335,1220,14810,6567
4808013,4808013,Norglenwold,10,55,50,115,50,280,211
4808022,4808022,Lacombe County,580,2020,2825,3305,1620,10350,4668
4808023,4808023,Birchcliff,5,25,20,40,25,115,98
4808024,4808024,Eckville,85,180,350,285,215,1115,465
4808025,4808025,Half Moon Bay,5,0,5,20,15,45,56
4808026,4808026,Bentley,70,185,310,335,180,1080,463
4808027,4808027,Sunbreaker Cove,0,5,5,30,35,75,240
4808028,4808028,Gull Lake,5,25,35,65,40,170,244
4808029,4808029,Blackfalds,995,1950,4375,1650,350,9320,3552
4808031,4808031,Lacombe,830,2750,4150,3275,2055,13060,5034
4808032,4808032,Clive,40,150,265,190,75,720,306
4808034,4808034,Alix,40,120,200,245,125,730,385
4808038,4808038,Ponoka County,600,1900,2640,3165,1490,9795,4199
4808039,4808039,Ponoka,480,1280,2240,1930,1295,7225,3301
4808042,4808042,Parkland Beach,10,20,30,65,40,165,213
4808044,4808044,Rimbey,165,420,690,575,725,2575,1160
4808811,4808811,Samson 137,385,1145,1105,605,145,3385,878
4808812,4808812,Samson 137A,0,0,0,0,0,0,6
4808813,4808813,Montana 139,90,225,205,90,20,630,143
4809002,4809002,Clearwater County,695,2225,3245,3825,1960,11950,5486
4809005,4809005,Burnstick Lake,0,0,0,0,0,0,0
4809010,4809010,Caroline,35,90,145,140,110,520,259
4809015,4809015,Rocky Mountain House,430,1290,2250,1620,1040,6630,2954
4809806,4809806,O'Chiese 203,95,270,270,105,35,775,265
4809809,4809809,Sunchild 202,60,290,250,120,25,745,187
4809810,4809810,Big Horn 144A,35,85,75,30,5,230,59
4810001,4810001,Camrose County,530,1655,2320,2685,1265,8455,3492
4810002,4810002,Bashaw,40,95,180,240,265,820,418
4810003,4810003,Rosalind,10,30,45,65,45,195,95
4810004,4810004,Ferintosh,15,25,60,75,50,225,103
4810006,4810006,Edberg,5,35,30,50,30,150,65
4810009,4810009,Bawlf,25,75,130,120,75,425,175
4810011,4810011,Camrose,1095,3080,5810,4725,4030,18740,8520
4810012,4810012,Bittern Lake,15,40,75,75,20,225,88
4810014,4810014,Hay Lakes,35,95,180,135,50,495,203
4810016,4810016,Beaver County,350,1180,1625,1845,900,5900,2381
4810018,4810018,Tofield,120,355,605,505,495,2080,864
4810019,4810019,Ryley,35,75,135,140,105,490,235
4810021,4810021,Holden,5,80,65,105,105,360,167
4810022,4810022,Viking,55,155,250,290,350,1100,505
4810026,4810026,Minburn County No. 27,215,640,795,1010,535,3195,1380
4810028,4810028,Vegreville,285,980,1640,1540,1265,5710,2734
4810031,4810031,Innisfree,0,25,30,70,80,205,126
4810034,4810034,Mannville,70,145,245,195,170,825,377
4810036,4810036,Vermilion River County,475,1870,2380,2480,1065,8270,3268
4810038,4810038,Paradise Valley,20,40,60,30,25,175,76
4810039,4810039,Lloydminster (Part),1430,4105,7375,4710,2015,19635,8444
4810041,4810041,Kitscoty,95,225,360,195,55,930,337
4810042,4810042,Vermilion,245,720,1360,980,780,4085,1988
4810044,4810044,Marwayne,30,130,195,135,70,560,245
4810046,4810046,Dewberry,10,35,55,50,35,185,104
4810048,4810048,Two Hills County No. 21,275,860,830,830,540,3335,1499
4810051,4810051,Myrnam,20,55,80,90,85,330,177
4810052,4810052,Two Hills,155,355,380,210,255,1355,478
4810056,4810056,Willingdon,25,50,65,80,90,310,160
4810058,4810058,Lamont County,180,645,950,1305,810,3890,1919
4810059,4810059,Andrew,15,50,90,145,115,415,266
4810061,4810061,Mundare,45,150,205,255,200,855,390
4810062,4810062,Chipman,15,45,55,100,60,275,145
4810064,4810064,Lamont,120,285,455,460,450,1770,695
4810066,4810066,Bruderheim,90,250,450,385,130,1305,622
4810068,4810068,Improvement District No. 13 Elk Island,0,0,0,0,0,0,6
4810805,4810805,Makaoo (Part) 120,35,55,60,50,5,205,49
4811001,4811001,Wetaskiwin County No. 10,590,1970,2750,3775,2095,11180,5556
4811002,4811002,Wetaskiwin,795,2305,3830,3195,2525,12650,5563
4811003,4811003,Argentia Beach,0,0,0,0,0,0,100
4811004,4811004,Grandview,0,5,10,35,60,110,210
4811005,4811005,Poplar Bay,5,15,5,40,40,105,179
4811006,4811006,Crystal Springs,0,0,5,15,20,40,108
4811007,4811007,Norris Beach,0,0,0,0,0,0,94
4811008,4811008,Ma-Me-O Beach,0,0,5,35,65,105,259
4811009,4811009,Silver Beach,0,10,5,20,35,70,100
4811011,4811011,Millet,135,300,580,595,330,1940,866
4811012,4811012,Leduc County,775,2670,3915,4455,1975,13790,5960
4811013,4811013,Beaumont,1565,4115,6720,3975,1020,17395,5980
4811016,4811016,Leduc,2380,5670,11600,6700,3640,29990,12264
4811018,4811018,Devon,430,1370,2195,1765,830,6590,2493
4811019,4811019,Calmar,170,425,805,620,210,2230,861
4811020,4811020,Sundance Beach,0,15,20,40,20,95,148
4811021,4811021,Thorsby,90,205,295,250,145,985,428
4811022,4811022,Itaska Beach,0,0,0,0,0,0,78
4811023,4811023,Golden Days,5,15,30,70,50,170,293
4811024,4811024,Warburg,40,140,215,195,165,755,335
4811026,4811026,Breton,30,105,160,160,120,575,292
4811031,4811031,Drayton Valley,545,1340,2805,1730,815,7235,3116
4811032,4811032,Brazeau County,495,1620,2365,2430,865,7775,3194
4811034,4811034,Parkland County,1630,6405,8690,11020,4345,32090,12910
4811038,4811038,Seba Beach,0,20,30,60,65,175,323
4811039,4811039,Betula Beach,0,0,0,0,0,0,40
4811041,4811041,Point Alison,0,0,0,0,0,0,31
4811042,4811042,Lakeview,0,0,0,0,0,0,23
4811044,4811044,Kapasiwin,0,0,0,0,0,0,41
4811045,4811045,Wabamun,35,125,180,195,145,680,290
4811046,4811046,Spring Lake,50,130,215,235,75,705,303
4811048,4811048,Stony Plain,1090,3335,5620,4330,2810,17185,6954
4811049,4811049,Spruce Grove,2770,6910,13215,7620,3535,34050,13109
4811052,4811052,Strathcona County,5370,19835,30570,28535,13730,98040,36354
4811056,4811056,Fort Saskatchewan,1840,4375,9560,5675,2690,24140,9939
4811059,4811059,Sturgeon County,1260,4320,6185,6275,2465,20505,7337
4811061,4811061,Edmonton,60070,155300,374870,229875,112440,932555,387950
4811062,4811062,St. Albert,3580,12990,20155,18805,10065,65595,24446
4811064,4811064,Gibbons,255,695,1160,760,280,3150,1223
4811065,4811065,Redwater,95,355,600,670,320,2040,946
4811066,4811066,Bon Accord,125,315,535,440,115,1530,578
4811068,4811068,Morinville,815,2030,3720,2365,915,9845,3611
4811069,4811069,Legal,125,290,445,310,180,1350,465
4811801,4811801,Ermineskin 138,295,970,790,330,65,2450,523
4811802,4811802,Pigeon Lake 138A,40,165,125,65,35,430,99
4811803,4811803,Louis Bull 138B,170,475,365,140,25,1175,276
4811804,4811804,Stony Plain 135,185,500,645,275,95,1700,576
4811805,4811805,Alexander 134,90,360,360,215,80,1105,349
4811806,4811806,Wabamun 133A,175,600,490,240,85,1590,369
4811807,4811807,Wabamun 133B,0,0,0,0,0,0,5
4812002,4812002,Cold Lake,1315,2895,6705,3130,920,14965,6657
4812004,4812004,Bonnyville No. 87,945,2985,4195,3830,1615,13570,5667
4812009,4812009,Bonnyville,395,1050,2105,1310,560,5420,2499
4812011,4812011,Bonnyville Beach,5,20,10,25,15,75,70
4812012,4812012,Glendon,40,100,190,110,70,510,234
4812013,4812013,Pelican Narrows,10,30,40,50,25,155,65
4812014,4812014,St. Paul County No. 19,340,1240,1490,1920,1055,6045,3562
4812016,4812016,Elk Point,90,285,460,345,255,1435,642
4812018,4812018,St. Paul,425,1060,2010,1270,1060,5825,2378
4812020,4812020,Horseshoe Bay,5,10,15,20,20,70,88
4812022,4812022,Smoky Lake County,280,780,1050,1295,715,4120,2248
4812024,4812024,Vilna,15,40,55,75,100,285,143
4812026,4812026,Waskatenau,10,15,60,75,35,195,129
4812029,4812029,Smoky Lake,35,130,200,270,335,970,499
4812037,4812037,Lac la Biche County,525,1785,2610,2305,1105,8330,3998
4812038,4812038,Improvement District No. 349,0,0,0,0,0,0,0
4812802,4812802,Unipouheos 121,85,330,320,145,40,920,232
4812804,4812804,Puskiakiwenin 122,75,170,190,80,15,530,129
4812806,4812806,Saddle Lake 125,0,0,0,0,0,0,
4812808,4812808,White Fish Lake 128,140,440,440,230,75,1325,319
4812810,4812810,Cold Lake 149,60,195,225,145,55,680,222
4812811,4812811,Kehewin 123,95,330,325,170,50,970,256
4812813,4812813,Cold Lake 149A,5,10,15,10,5,45,19
4812815,4812815,Cold Lake 149B,10,40,45,40,20,155,53
4812828,4812828,Beaver Lake 131,45,125,160,85,15,430,115
4812840,4812840,Heart Lake 167,25,45,75,25,10,180,57
4813001,4813001,Lac Ste. Anne County,595,1875,2905,3745,1795,10915,5385
4813002,4813002,Mayerthorpe,75,200,360,345,340,1320,600
4813003,4813003,Nakamun Park,0,5,15,40,30,90,148
4813005,4813005,Val Quentin,5,15,45,95,80,240,224
4813006,4813006,West Cove,10,10,35,70,35,160,214
4813007,4813007,Yellowstone,5,15,20,45,35,120,145
4813008,4813008,Ross Haven,0,15,35,65,35,150,215
4813009,4813009,Castle Island,0,0,0,0,0,0,19
4813010,4813010,Silver Sands,0,15,30,65,40,150,165
4813011,4813011,Sunset Point,0,20,25,75,50,170,337
4813012,4813012,Alberta Beach,55,130,225,380,225,1015,743
4813013,4813013,Birch Cove,0,5,5,20,10,40,74
4813014,4813014,Onoway,50,225,295,275,185,1030,374
4813015,4813015,South View,5,5,10,25,20,65,88
4813016,4813016,Sandy Beach,15,30,70,120,45,280,264
4813017,4813017,Sunrise Beach,5,15,25,70,25,140,139
4813018,4813018,Barrhead County No. 11,415,1355,1635,1915,965,6285,2830
4813019,4813019,Barrhead,260,750,1245,1080,1240,4575,2009
4813028,4813028,Westlock County,385,1515,1870,2215,1255,7240,3009
4813029,4813029,Woodlands County,240,940,1380,1635,545,4740,1950
4813030,4813030,Whitecourt,835,2175,4095,2470,625,10200,4253
4813031,4813031,Westlock,250,900,1380,1185,1380,5095,2333
4813032,4813032,Clyde,20,95,125,135,65,440,198
4813033,4813033,Larkspur,0,0,5,15,20,40,89
4813036,4813036,Thorhild County,135,500,785,1115,715,3250,1836
4813044,4813044,Athabasca County,390,1490,2105,2560,1310,7855,4093
4813045,4813045,Mewatha Beach,0,0,5,45,35,85,177
4813046,4813046,Boyle,50,135,215,260,170,830,464
4813047,4813047,Sunset Beach,0,5,0,15,30,50,99
4813048,4813048,Athabasca,180,585,920,760,530,2975,1313
4813049,4813049,Island Lake,10,35,35,80,60,220,263
4813051,4813051,Island Lake South,0,0,20,35,15,70,74
4813053,4813053,Bondiss,5,10,10,50,35,110,195
4813055,4813055,South Baptiste,0,10,15,20,20,65,77
4813057,4813057,West Baptiste,0,0,0,0,0,0,47
4813061,4813061,Whispering Hills,10,20,35,60,35,160,136
4813811,4813811,Alexis 133,75,230,250,150,50,755,209
4814003,4814003,Yellowhead County,615,2135,3005,3530,1710,10995,5048
4814019,4814019,Hinton,660,1860,3470,2835,1070,9895,4343
4814024,4814024,Edson,570,1535,3180,2180,940,8405,3762
4814028,4814028,Improvement District No. 25 Willmore Wilderness,0,0,0,0,0,0,0
4815007,4815007,Crowsnest Pass,255,795,1335,1945,1255,5585,3225
4815013,4815013,Kananaskis,15,25,115,50,15,220,79
4815015,4815015,Bighorn No. 8,75,200,400,455,205,1335,766
4815023,4815023,Canmore,700,2010,5070,4385,1835,14000,7963
4815027,4815027,Ghost Lake,5,15,10,40,20,90,87
4815030,4815030,Waiparous,5,10,10,15,20,60,48
4815032,4815032,Improvement District No. 9 Banff,0,0,0,0,0,0,31
4815033,4815033,Jasper,195,705,1930,1305,465,4600,1702
4815035,4815035,Banff,290,920,4090,1890,650,7840,2729
4815037,4815037,Improvement District No. 12 Jasper Park,0,0,0,0,0,0,0
4815045,4815045,Ranchland No. 66,5,25,25,25,10,90,57
4815802,4815802,"Stoney 142, 143, 144",445,1250,1350,510,160,3715,855
4816037,4816037,Wood Buffalo,5950,11710,34200,17785,1955,71600,30713
4816051,4816051,Improvement District No. 24 Wood Buffalo,120,255,175,75,20,645,123
4816817,4816817,Janvier 194,55,115,145,75,20,410,143
4816821,4816821,Gregoire Lake 176,15,45,65,45,15,185,74
4816822,4816822,Gregoire Lake 176A,15,30,50,35,5,135,49
4816831,4816831,Chipewyan 201A,0,0,0,0,0,0,0
4816849,4816849,Old Fort 217,0,0,0,0,0,0,0
4816850,4816850,Allison Bay 219,20,30,30,35,10,125,46
4816852,4816852,Dog Head 218,10,15,30,30,15,100,49
4816859,4816859,Fort Mackay,90,185,280,150,45,750,303
4816860,4816860,Thebathi 196,0,0,0,0,0,0,19
4816861,4816861,Thabacha Náre 196A,0,0,0,0,0,0,16
4817021,4817021,High Prairie,205,570,825,595,360,2555,1116
4817024,4817024,Swan Hills,80,240,460,405,115,1300,724
4817026,4817026,Northern Sunrise County,140,375,540,610,240,1905,798
4817027,4817027,Big Lakes County,315,1345,1490,1715,820,5685,2728
4817029,4817029,Slave Lake,585,1440,2670,1525,440,6660,2762
4817031,4817031,Opportunity No. 17,325,790,1110,675,275,3175,1554
4817033,4817033,Lesser Slave River No.124,130,560,715,945,445,2795,1310
4817039,4817039,Nampa,25,75,120,95,40,355,176
4817062,4817062,Clear Hills,310,840,840,650,375,3015,1062
4817064,4817064,Hines Creek,15,60,90,95,85,345,151
4817076,4817076,Northern Lights County,270,980,1145,1225,580,4200,1846
4817078,4817078,Manning,75,230,400,245,230,1180,544
4817093,4817093,High Level,320,700,1300,705,145,3170,1339
4817095,4817095,Mackenzie County,1505,3385,3630,1820,845,11185,3567
4817097,4817097,Rainbow Lake,70,190,315,185,35,795,475
4817817,4817817,Jean Baptiste Gambler 183,25,60,80,65,20,250,86
4817818,4817818,Wabasca 166,20,45,50,40,10,165,49
4817819,4817819,Wabasca 166A,60,220,200,130,60,670,213
4817821,4817821,Wabasca 166B,30,60,70,25,5,190,52
4817822,4817822,Wabasca 166C,25,55,60,35,10,185,58
4817823,4817823,Wabasca 166D,150,265,310,165,70,960,273
4817824,4817824,Utikoomak Lake 155,120,240,230,95,40,725,193
4817825,4817825,Clear Hills 152C,0,0,0,0,0,0,5
4817827,4817827,Utikoomak Lake 155A,15,40,40,25,10,130,34
4817828,4817828,Drift Pile River 150,80,245,255,195,55,830,277
4817829,4817829,Sucker Creek 150A,50,195,220,160,60,685,274
4817830,4817830,Kapawe'no First Nation (Pakashan 150D),0,0,0,0,0,0,7
4817831,4817831,Swan River 150E,45,135,150,60,30,420,123
4817832,4817832,Sawridge 150G,0,0,0,0,0,0,31
4817833,4817833,Sawridge 150H,0,0,0,0,0,0,4
4817835,4817835,Fox Lake 162,345,760,670,220,50,2045,351
4817836,4817836,Kapawe'no First Nation (Freeman 150B),20,45,50,30,10,155,45
4817837,4817837,John d'Or Prairie 215,165,485,385,120,45,1200,237
4817838,4817838,Tall Cree 173,30,95,80,45,10,260,53
4817840,4817840,Tall Cree 173A,30,70,80,40,0,220,58
4817841,4817841,Beaver Ranch 163,0,0,0,0,0,0,7
4817842,4817842,Boyer 164,25,80,80,40,5,230,67
4817843,4817843,Child Lake 164A,15,60,65,60,10,210,62
4817845,4817845,Hay Lake 209,75,205,335,200,75,890,277
4817848,4817848,Bushe River 207,60,160,165,85,25,495,142
4817849,4817849,Upper Hay River 212,15,85,105,70,20,295,115
4817853,4817853,Little Buffalo,70,145,155,65,15,450,130
4817854,4817854,Carcajou 187,0,0,0,0,0,0,0
4817855,4817855,Desmarais,10,15,60,30,5,120,91
4817856,4817856,Woodland Cree 226,90,215,255,130,45,735,211
4817857,4817857,Woodland Cree 228,25,50,45,15,5,140,36
4817859,4817859,Fort Vermilion 173B,5,35,40,25,10,115,25
4817860,4817860,Loon Lake 235,80,170,195,85,25,555,157
4818002,4818002,Fox Creek,120,400,780,550,120,1970,1054
4818005,4818005,Grande Cache,175,690,1390,940,365,3560,1759
4818015,4818015,Greenview No. 16,350,1165,1645,1660,760,5580,2473
4818018,4818018,Valleyview,120,320,620,455,355,1870,833
4818816,4818816,Sturgeon Lake 154,140,445,480,310,80,1455,455
4818818,4818818,Sturgeon Lake 154A,0,20,15,20,10,65,16
4819006,4819006,Grande Prairie County No. 1,1675,5005,7205,6395,2015,22295,8291
4819008,4819008,Hythe,65,140,215,190,230,840,320
4819009,4819009,Beaverlodge,180,530,770,585,405,2470,1024
4819011,4819011,Wembley,150,330,620,335,80,1515,618
4819012,4819012,Grande Prairie,5285,12035,28145,13180,4510,63155,26204
4819014,4819014,Sexsmith,280,660,1030,495,155,2620,937
4819038,4819038,Peace River,540,1425,2670,1565,650,6850,2970
4819041,4819041,Smoky River No. 130,130,440,545,650,250,2015,891
4819042,4819042,McLennan,35,145,180,170,155,685,296
4819044,4819044,Donnelly,20,75,90,100,45,330,170
4819046,4819046,Falher,45,185,290,225,300,1045,482
4819048,4819048,Girouxville,15,30,70,50,45,210,130
4819049,4819049,Birch Hills County,110,350,390,445,250,1545,616
4819054,4819054,Spirit River No. 133,40,120,165,250,130,705,306
4819056,4819056,Rycroft,40,105,195,180,100,620,316
4819058,4819058,Spirit River,40,160,265,275,265,1005,487
4819059,4819059,Saddle Hills County,160,440,575,700,350,2225,978
4819066,4819066,Fairview No. 136,95,360,415,505,230,1605,683
4819068,4819068,Fairview,160,575,925,755,585,3000,1363
4819071,4819071,Peace No. 135,75,325,545,525,280,1750,639
4819072,4819072,Berwyn,40,100,165,155,95,555,255
4819074,4819074,Grimshaw,235,525,990,615,350,2715,1194
4819815,4819815,Horse Lakes 152B,65,160,160,60,20,465,112
4819826,4819826,Duncan's 151A,15,40,50,30,10,145,56
5901003,5901003,Elkford,170,505,830,770,235,2510,1521
5901006,5901006,Sparwood,265,650,1260,1100,490,3765,2130
5901012,5901012,Fernie,375,785,2050,1310,740,5260,3032
5901017,5901017,East Kootenay A,110,305,605,625,300,1945,1320
5901019,5901019,East Kootenay B,80,280,475,715,425,1975,1234
5901022,5901022,Cranbrook,1005,3405,5715,5735,4170,20030,8799
5901028,5901028,Kimberley,350,1170,2085,2120,1700,7425,4225
5901035,5901035,East Kootenay C,240,995,1360,2275,1160,6030,2836
5901037,5901037,East Kootenay E,60,210,385,640,460,1755,1161
5901039,5901039,Invermere,175,565,1055,905,695,3395,2032
5901040,5901040,Radium Hot Springs,30,95,175,295,180,775,876
5901043,5901043,Canal Flats,40,105,175,220,125,665,375
5901046,5901046,East Kootenay F,70,280,605,990,775,2720,3267
5901048,5901048,East Kootenay G,60,200,360,550,295,1465,899
5901801,5901801,Tobacco Plains 2,0,20,25,25,5,75,59
5901802,5901802,Isidore's Ranch 4,0,0,0,0,0,0,0
5901803,5901803,Kootenay 1,10,35,50,60,20,175,60
5901804,5901804,Columbia Lake 3,5,20,55,45,25,150,186
5901805,5901805,Cassimayooks (Mayook) 5,0,0,0,0,0,0,2
5901806,5901806,Shuswap,20,55,145,70,45,335,183
5903004,5903004,Creston,185,610,1050,1525,1980,5350,2744
5903010,5903010,Central Kootenay A,50,190,320,755,620,1935,1596
5903011,5903011,Salmo,40,190,275,345,295,1145,572
5903013,5903013,Central Kootenay B,210,905,840,1500,1190,4645,2090
5903015,5903015,Nelson,455,1745,3495,2900,1970,10565,5061
5903017,5903017,Central Kootenay C,70,190,280,515,430,1485,692
5903019,5903019,Slocan,5,45,65,95,45,255,183
5903023,5903023,Kaslo,30,135,180,325,285,955,555
5903027,5903027,Silverton,5,15,25,80,70,195,147
5903032,5903032,New Denver,20,40,90,140,190,480,320
5903039,5903039,Central Kootenay D,35,180,270,480,375,1340,1072
5903041,5903041,Central Kootenay E,145,535,980,1295,815,3770,2177
5903043,5903043,Central Kootenay F,175,630,1045,1330,775,3955,1925
5903045,5903045,Castlegar,400,1175,2275,2320,1860,8030,3655
5903047,5903047,Central Kootenay G,70,275,470,570,235,1620,818
5903050,5903050,Nakusp,70,220,355,500,450,1595,807
5903052,5903052,Central Kootenay H,255,715,1320,1535,840,4665,2449
5903056,5903056,Central Kootenay I,130,345,675,890,505,2545,1177
5903058,5903058,Central Kootenay J,135,495,835,1130,540,3135,1546
5903060,5903060,Central Kootenay K,30,180,250,690,535,1685,1092
5903807,5903807,Creston 1,5,30,50,20,5,110,48
5905005,5905005,Fruitvale,95,290,480,605,450,1920,864
5905009,5905009,Montrose,45,155,235,335,220,990,427
5905014,5905014,Trail,340,1080,1965,2260,2065,7710,3990
5905018,5905018,Warfield,75,275,490,525,335,1700,809
5905023,5905023,Rossland,230,675,1200,1145,470,3720,1949
5905026,5905026,Kootenay Boundary A,90,320,455,705,320,1890,790
5905030,5905030,Kootenay Boundary B / Lower Columbia-Old-Glory,55,165,320,570,330,1440,714
5905032,5905032,Grand Forks,130,545,820,1205,1345,4045,1944
5905037,5905037,Midway,20,75,85,210,265,655,321
5905042,5905042,Greenwood,20,65,85,245,250,665,416
5905050,5905050,Kootenay Boundary C / Christina Lake,30,165,205,470,470,1340,1366
5905052,5905052,Kootenay Boundary D / Rural Grand Forks,100,430,565,1180,950,3225,1496
5905054,5905054,Kootenay Boundary E / West Boundary,70,310,460,785,530,2155,3235
5907005,5907005,Osoyoos,145,470,865,1425,2190,5095,3151
5907009,5907009,Keremeos,40,150,215,410,685,1500,782
5907014,5907014,Oliver,200,610,970,1370,1785,4935,2249
5907022,5907022,Okanagan-Similkameen A,50,175,345,720,575,1865,963
5907024,5907024,Princeton,105,385,700,890,750,2830,1535
5907026,5907026,Okanagan-Similkameen B,45,160,235,345,260,1045,488
5907028,5907028,Okanagan-Similkameen C,105,430,675,1210,1135,3555,1651
5907035,5907035,Summerland,405,1595,2345,3750,3525,11620,5240
5907041,5907041,Penticton,1245,4365,8245,10100,9810,33765,16895
5907047,5907047,Okanagan-Similkameen D,155,765,1115,2165,1695,5895,3019
5907049,5907049,Okanagan-Similkameen E,60,260,390,700,505,1915,1002
5907051,5907051,Okanagan-Similkameen F,65,365,395,780,415,2020,835
5907053,5907053,Okanagan-Similkameen G,60,245,350,720,850,2225,1749
5907055,5907055,Okanagan-Similkameen H,45,175,310,805,615,1950,1913
5907801,5907801,Lower Similkameen 2,0,0,0,0,0,0,20
5907802,5907802,Osoyoos 1,35,90,155,225,265,770,449
5907803,5907803,Penticton 1,60,270,335,420,700,1785,854
5907805,5907805,Chopaka 7 & 8,5,15,30,15,20,85,27
5907806,5907806,Blind Creek 6,0,0,0,0,0,0,10
5907807,5907807,Chuchuwayha 2,5,15,25,10,5,60,28
5907808,5907808,Alexis 9,0,0,0,0,0,0,6
5907809,5907809,Ashnola 10,5,30,20,25,15,95,28
5909009,5909009,Hope,205,785,1295,2115,1790,6190,3123
5909014,5909014,Fraser Valley A,15,35,65,165,130,410,316
5909016,5909016,Fraser Valley B,25,95,165,360,265,910,726
5909020,5909020,Chilliwack,5065,16065,24685,22800,15170,83785,34038
5909027,5909027,Harrison Hot Springs,35,155,265,495,520,1470,928
5909032,5909032,Kent,280,860,1645,1815,1475,6075,2351
5909034,5909034,Fraser Valley D,115,300,405,455,255,1530,596
5909035,5909035,Fraser Valley H,50,210,375,755,470,1860,1391
5909036,5909036,Fraser Valley E,45,180,350,585,370,1530,738
5909048,5909048,Fraser Valley C,35,65,210,405,295,1010,929
5909052,5909052,Abbotsford,8480,26445,46265,36360,23860,141410,51770
5909056,5909056,Mission,2255,7330,11960,11680,5590,38815,14101
5909060,5909060,Fraser Valley F,45,220,335,450,225,1275,754
5909062,5909062,Fraser Valley G,85,300,430,625,335,1775,991
5909804,5909804,Chawathil 4,20,55,60,40,20,195,52
5909805,5909805,Inkahtsaph 6,0,0,0,0,0,0,1
5909806,5909806,Kopchitchin 2,0,0,10,15,5,30,21
5909807,5909807,Ohamil 1,5,40,30,10,10,95,24
5909808,5909808,Puckatholetchin 11,0,0,0,0,0,0,2
5909809,5909809,Saddle Rock 9,0,0,0,0,0,0,0
5909810,5909810,Lukseetsissum 9,0,0,0,0,0,0,9
5909812,5909812,Schkam 2,5,50,40,30,0,125,38
5909814,5909814,Skawahlook 1,0,0,0,0,0,0,1
5909815,5909815,Speyum 3,0,0,0,0,0,0,1
5909816,5909816,Spuzzum 1,0,0,0,0,0,0,15
5909817,5909817,Tuckkwiowhum 1,0,0,0,0,0,0,16
5909818,5909818,Yale Town 1,0,0,0,0,0,0,8
5909819,5909819,Kahmoose 4,5,10,20,25,10,70,34
5909821,5909821,Kwawkwawapilt 6,0,15,15,55,240,325,200
5909824,5909824,Skwah 4,5,50,70,45,15,185,64
5909825,5909825,Skwali 3,0,0,0,0,0,0,3
5909826,5909826,Skway 5,10,20,30,20,0,80,34
5909827,5909827,Soowahlie 14,15,60,80,65,30,250,76
5909830,5909830,Tzeachten 13,30,135,190,535,1460,2350,1205
5909831,5909831,Yakweakwioose 12,5,10,10,20,0,45,12
5909832,5909832,Seabird Island,90,225,245,160,50,770,231
5909833,5909833,Scowlitz 1,0,0,0,0,0,0,4
5909834,5909834,Tseatah 2,0,0,0,0,0,0,6
5909835,5909835,Aitchelitch 9,0,0,0,0,0,0,5
5909836,5909836,Boston Bar 1A,0,0,0,0,0,0,0
5909837,5909837,Cheam 1,15,50,80,40,20,205,77
5909838,5909838,Schelowat 1,0,0,0,0,0,0,4
5909839,5909839,Chehalis 5,40,135,175,150,55,555,170
5909841,5909841,Stullawheets 8,0,15,5,10,15,45,24
5909842,5909842,Douglas 8,10,15,20,15,0,60,22
5909843,5909843,Peters 1,0,0,0,0,0,0,13
5909844,5909844,Popkum 1,0,0,0,0,0,0,3
5909845,5909845,Skookumchuck 4,10,25,35,20,10,100,28
5909847,5909847,Bucktum 4,0,0,0,0,0,0,1
5909848,5909848,Tipella 7,0,0,0,0,0,0,1
5909849,5909849,Skwahla 2,0,0,0,0,0,0,0
5909850,5909850,Boothroyd 13,0,0,0,0,0,0,0
5909852,5909852,Paqulh,0,0,0,0,0,0,0
5909875,5909875,Q'alatkú7em,5,30,25,10,10,80,24
5909876,5909876,Albert Flat 5,0,0,0,0,0,0,9
5909877,5909877,Upper Sumas 6,10,35,65,40,20,170,64
5909878,5909878,Matsqui Main 2,15,30,40,20,0,105,32
5909879,5909879,Holachten 8,15,50,75,85,75,300,139
5909880,5909880,Lakahahmen 11,10,40,50,45,35,180,84
5909881,5909881,Skweahm 10,5,25,25,85,75,215,111
5909882,5909882,Squawkum Creek 3,10,35,40,25,15,125,28
5909883,5909883,Sachteen,0,0,0,0,0,0,3
5909884,5909884,Skowkale,30,100,150,185,370,835,381
5909885,5909885,Squiaala,15,35,55,20,0,125,48
5915001,5915001,Langley,6645,22515,36000,33575,18565,117300,43720
5915002,5915002,Langley,1400,3790,8685,7065,4945,25885,12264
5915004,5915004,Surrey,29090,97785,177750,140265,72990,517880,181159
5915007,5915007,White Rock,535,2040,4050,6550,6780,19955,10856
5915011,5915011,Delta,4505,18835,28595,31145,19155,102235,37590
5915015,5915015,Richmond,8905,29865,64325,61570,33645,198310,77478
5915020,5915020,Greater Vancouver A,795,3515,6905,3365,1575,16155,8542
5915022,5915022,Vancouver,24615,74185,262150,172985,97555,631490,309418
5915025,5915025,Burnaby,10865,32800,87380,64850,36850,232745,98030
5915029,5915029,New Westminster,3240,8725,26975,21240,10820,71000,34235
5915034,5915034,Coquitlam,6895,24415,46100,42485,19380,139275,54393
5915036,5915036,Belcarra,15,105,120,245,150,635,292
5915038,5915038,Anmore,70,525,575,840,195,2205,723
5915039,5915039,Port Coquitlam,3005,10520,19430,18200,7470,58625,22586
5915043,5915043,Port Moody,1850,6310,11100,10215,4080,33555,13318
5915046,5915046,North Vancouver,4000,16605,23225,27035,15050,85915,32624
5915051,5915051,North Vancouver,2470,7080,19175,15655,8525,52905,26426
5915055,5915055,West Vancouver,1170,7785,8560,13130,11805,42450,18649
5915062,5915062,Bowen Island,165,645,800,1295,765,3670,1915
5915065,5915065,Lions Bay,50,240,300,465,285,1340,547
5915070,5915070,Pitt Meadows,1025,3210,5715,5685,2930,18565,7356
5915075,5915075,Maple Ridge,4590,15230,25450,25065,11920,82255,31400
5915801,5915801,Semiahmoo,5,15,35,35,25,115,64
5915802,5915802,Tsawwassen,20,100,190,280,215,805,368
5915803,5915803,Musqueam 2,80,350,470,460,290,1650,615
5915804,5915804,Coquitlam 2,0,0,0,0,0,0,0
5915805,5915805,Coquitlam 1,10,20,25,10,0,65,25
5915806,5915806,Burrard Inlet 3,95,195,645,630,290,1855,932
5915807,5915807,Mission 1,30,125,215,150,60,580,178
5915808,5915808,Capilano 5,85,455,1025,870,510,2945,1433
5915809,5915809,Barnston Island 3,0,0,0,0,0,0,16
5915810,5915810,Musqueam 4,0,0,0,0,0,0,4
5915811,5915811,Seymour Creek 2,0,25,45,35,15,120,40
5915813,5915813,Katzie 2,0,10,15,10,5,40,15
5915816,5915816,McMillan Island 6,5,25,25,30,10,95,32
5915825,5915825,Matsqui 4,0,5,15,60,400,480,286
5915830,5915830,Katzie 1,15,60,105,60,10,250,83
5915835,5915835,Langley 5,0,0,0,0,0,0,0
5915840,5915840,Whonnock 1,0,0,0,0,0,0,1
5917005,5917005,North Saanich,315,1495,2040,3835,3560,11245,4936
5917010,5917010,Sidney,370,1260,2110,3155,4790,11685,5960
5917015,5917015,Central Saanich,700,2480,4140,5215,4280,16815,7121
5917021,5917021,Saanich,4765,17485,35455,32730,23710,114145,49422
5917027,5917027,Saltspring Island,285,1435,2100,3500,3235,10555,5871
5917029,5917029,Southern Gulf Islands,95,390,605,1600,2045,4735,4945
5917030,5917030,Oak Bay,615,2815,3605,5345,5715,18095,8122
5917034,5917034,Victoria,2940,7765,34450,22600,18050,85805,49212
5917040,5917040,Esquimalt,820,2040,6290,5350,3145,17645,8742
5917041,5917041,Colwood,970,2870,5315,4975,2720,16850,6867
5917042,5917042,Metchosin,165,670,1080,1770,1030,4715,1932
5917044,5917044,Langford,2255,6125,12780,9805,4390,35355,14906
5917047,5917047,View Royal,515,1615,3110,3330,1845,10415,4299
5917049,5917049,Highlands,95,365,625,835,300,2220,862
5917052,5917052,Sooke,730,2355,3780,3985,2150,13000,5599
5917054,5917054,Juan de Fuca (Part 1),190,655,1175,1735,905,4660,2337
5917056,5917056,Juan de Fuca (Part 2),10,20,55,75,25,185,152
5917801,5917801,Cole Bay 3,30,100,95,85,30,340,97
5917802,5917802,Union Bay 4,10,20,30,20,10,90,40
5917803,5917803,East Saanich 2,75,220,285,470,630,1680,796
5917804,5917804,South Saanich 1,70,245,270,195,50,830,248
5917805,5917805,Galiano Island 9,0,0,0,0,0,0,2
5917809,5917809,Becher Bay 1,0,35,55,25,15,130,54
5917811,5917811,Esquimalt,0,0,0,0,0,0,
5917812,5917812,New Songhees 1A,85,235,465,615,445,1845,917
5917815,5917815,Gordon River 2,10,15,30,40,10,105,33
5917819,5917819,T'Sou-ke,10,55,75,70,20,230,90
5919008,5919008,North Cowichan,1325,4620,7155,9185,7395,29680,13416
5919012,5919012,Duncan,220,610,1110,1330,1680,4950,2523
5919013,5919013,Cowichan Valley D,145,475,740,1115,775,3250,1465
5919015,5919015,Cowichan Valley G,50,220,405,880,775,2330,1404
5919016,5919016,Lake Cowichan,145,460,830,1045,740,3220,1534
5919017,5919017,Cowichan Valley H,55,300,470,945,680,2450,1196
5919021,5919021,Ladysmith,390,1290,1925,2590,2335,8530,3754
5919033,5919033,Cowichan Valley F,55,200,370,635,375,1635,866
5919035,5919035,Cowichan Valley I,40,115,200,525,330,1210,1028
5919043,5919043,Cowichan Valley A,145,710,965,1790,1125,4735,2047
5919046,5919046,Cowichan Valley B,470,1560,2450,2915,1160,8555,3655
5919049,5919049,Cowichan Valley C,160,650,905,1600,1710,5025,2259
5919051,5919051,Cowichan Valley E,220,680,1115,1405,710,4130,1720
5919801,5919801,Halalt 2,10,45,65,45,5,170,39
5919802,5919802,Squaw-hay-one 11,0,0,0,0,0,0,10
5919803,5919803,Tsussie 6,20,25,40,20,0,105,27
5919804,5919804,Chemainus 13,70,225,250,135,40,720,172
5919808,5919808,Kil-pah-las 3,0,0,0,0,0,0,0
5919809,5919809,Penelakut Island 7,45,135,155,80,20,435,126
5919811,5919811,Shingle Point 4,0,0,0,0,0,0,0
5919812,5919812,Cowichan Lake,0,0,0,0,0,0,7
5919814,5919814,Malachan 11,15,40,65,30,15,165,74
5919815,5919815,Malahat 11,20,45,45,30,10,150,39
5919816,5919816,Oyster Bay 12,5,25,25,5,10,70,20
5919817,5919817,Portier Pass 5,0,0,0,0,0,0,0
5919818,5919818,Theik 2,0,0,0,0,0,0,9
5919820,5919820,Est-Patrolas 4,0,0,0,0,0,0,6
5919821,5919821,Tzart-Lam 5,0,0,0,0,0,0,13
5919822,5919822,Cowichan,160,590,715,440,180,2085,510
5921007,5921007,Nanaimo,4225,13485,26990,25640,20175,90515,40885
5921008,5921008,Lantzville,135,565,815,1255,840,3610,1517
5921010,5921010,Nanaimo A,325,1005,1760,2550,1415,7055,3116
5921014,5921014,Nanaimo B,75,335,550,1560,1520,4040,2987
5921016,5921016,Nanaimo C,95,480,715,1045,475,2810,1097
5921018,5921018,Parksville,345,1345,2170,3350,5300,12510,6445
5921023,5921023,Qualicum Beach,155,695,990,2445,4660,8945,4644
5921030,5921030,Nanaimo E,185,560,960,2245,2165,6115,3066
5921032,5921032,Nanaimo F,340,1205,2010,2700,1475,7730,3530
5921034,5921034,Nanaimo G,195,840,1180,2520,2720,7455,3553
5921036,5921036,Nanaimo H,110,375,630,1540,1240,3895,2436
5921804,5921804,Nanaimo Town 1,20,85,125,90,40,360,125
5921805,5921805,Nanoose,20,60,75,45,15,215,86
5921806,5921806,Qualicum,5,15,25,20,10,75,33
5921807,5921807,Nanaimo River,15,95,115,80,40,345,102
5923008,5923008,Port Alberni,835,2850,4405,5310,4290,17690,8567
5923019,5923019,Ucluelet,110,240,675,470,235,1730,841
5923025,5923025,Tofino,105,205,965,420,225,1920,1037
5923033,5923033,Alberni-Clayoquot B,10,55,90,180,90,425,220
5923035,5923035,Alberni-Clayoquot D,50,160,270,645,490,1615,1131
5923037,5923037,Alberni-Clayoquot E,105,435,640,935,645,2760,1257
5923039,5923039,Alberni-Clayoquot F,55,320,420,680,465,1940,863
5923047,5923047,Alberni-Clayoquot A,0,10,60,105,70,245,444
5923049,5923049,Alberni-Clayoquot C,40,135,225,200,75,675,359
5923801,5923801,Ahahswinis 1,0,30,30,25,30,115,61
5923802,5923802,Alberni 2,0,0,0,0,0,0,3
5923803,5923803,Anacla 12,10,15,30,35,15,105,44
5923804,5923804,Clakamucus 2,0,0,0,0,0,0,1
5923805,5923805,Elhlateese 2,0,0,0,0,0,0,12
5923806,5923806,Hesquiat 1,0,0,0,0,0,0,3
5923807,5923807,Ittatsoo 1,20,55,90,90,25,280,96
5923808,5923808,Marktosis 15,75,160,205,150,40,630,200
5923809,5923809,Numukamis 1,0,0,0,0,0,0,3
5923810,5923810,Macoah 1,0,0,0,0,0,0,11
5923813,5923813,Opitsat 1,20,30,55,30,15,150,53
5923814,5923814,Sachsa 4,0,0,0,0,0,0,2
5923816,5923816,Tsahaheh 1,60,135,200,110,45,550,199
5923822,5923822,Klehkoot 2,0,0,0,0,0,0,6
5923823,5923823,Esowista 3,5,10,25,25,15,80,37
5923824,5923824,Refuge Cove 6,0,5,10,20,5,40,40
5923825,5923825,Tin Wis 11,0,0,0,0,0,0,0
5924025,5924025,Gold River,40,200,205,470,305,1220,789
5924029,5924029,Zeballos,5,15,30,45,20,115,113
5924030,5924030,Tahsis,10,20,40,120,60,250,400
5924034,5924034,Campbell River,1540,5320,8805,9990,6930,32585,14810
5924039,5924039,Sayward,15,35,60,115,95,320,178
5924042,5924042,Strathcona D (Oyster Bay - Buttle Lake),195,615,995,1650,950,4405,2051
5924048,5924048,Strathcona A,30,85,150,300,195,760,440
5924052,5924052,Strathcona B,45,125,235,340,290,1035,788
5924054,5924054,Strathcona C,90,250,510,895,705,2450,1519
5924803,5924803,Ahaminaquus 12,0,0,0,0,0,0,0
5924804,5924804,Campbell River 11,10,80,90,130,55,365,154
5924805,5924805,Chenahkint 12,0,0,0,0,0,0,0
5924806,5924806,Houpsitas 6,5,70,65,30,20,190,53
5924812,5924812,Quinsam 12,15,60,85,95,30,285,107
5924813,5924813,Village Island 1,0,0,0,0,0,0,0
5924814,5924814,Yuquot 1,0,0,0,0,0,0,2
5924817,5924817,Cape Mudge 10,5,20,45,45,20,135,68
5924818,5924818,Squirrel Cove 8,0,0,0,0,0,0,0
5924820,5924820,Tork 7,0,0,15,30,10,55,38
5924833,5924833,Oclucje 7,0,0,0,0,0,0,11
5924835,5924835,Tsa Xana 18,15,55,65,35,20,190,61
5924836,5924836,Ehatis 11,10,35,35,10,0,90,21
5924840,5924840,Homalco 9,10,35,75,60,15,195,78
5926005,5926005,Comox,555,2200,3085,4095,4080,14015,6410
5926010,5926010,Courtenay,1175,3765,6855,7130,6685,25610,12013
5926014,5926014,Cumberland,235,640,1340,990,555,3760,1612
5926021,5926021,Comox Valley A,250,780,1385,2585,2215,7215,4360
5926022,5926022,Comox Valley B (Lazo North),205,1115,1345,2675,1740,7080,3243
5926024,5926024,Comox Valley C (Puntledge - Black Creek),360,1265,1985,3280,1740,8630,4324
5926801,5926801,Comox 1,15,30,55,85,50,235,114
5926802,5926802,Pentledge 2,0,0,0,0,0,0,0
5927008,5927008,Powell River,520,1940,2905,4225,3570,13160,6354
5927010,5927010,Powell River A,45,115,210,420,330,1120,1593
5927012,5927012,Powell River B,55,195,315,535,440,1540,851
5927016,5927016,Powell River C,85,225,445,760,555,2070,1110
5927018,5927018,Powell River D,15,90,150,425,400,1080,723
5927020,5927020,Powell River E,0,0,0,0,0,0,407
5927802,5927802,Sliammon 1,40,125,195,215,140,715,345
5927806,5927806,Sechelt (Part),0,0,0,0,0,0,17
5929005,5929005,Gibsons,160,525,1040,1445,1435,4605,2320
5929011,5929011,Sechelt,385,1175,2065,3125,3460,10210,5378
5929018,5929018,Sunshine Coast A,60,185,380,1025,965,2615,2329
5929022,5929022,Sunshine Coast B,90,360,520,1015,745,2730,1753
5929024,5929024,Sunshine Coast D,130,540,760,1185,795,3410,1776
5929026,5929026,Sunshine Coast E,145,625,785,1340,780,3675,1650
5929028,5929028,Sunshine Coast F,60,250,410,775,550,2045,1833
5929801,5929801,Chekwelp 26,0,0,0,0,0,0,0
5929803,5929803,Sechelt (Part),20,135,155,200,165,675,340
5931006,5931006,Squamish,1415,3405,7635,4880,2180,19515,7574
5931012,5931012,Pemberton,235,465,1120,615,150,2585,1028
5931017,5931017,Squamish-Lillooet C,90,295,545,560,180,1670,964
5931020,5931020,Whistler,500,1470,6205,2850,835,11860,10507
5931021,5931021,Squamish-Lillooet D,60,140,290,385,180,1055,589
5931026,5931026,Lillooet,85,335,525,800,535,2280,1207
5931032,5931032,Squamish-Lillooet A,5,5,55,75,50,190,538
5931034,5931034,Squamish-Lillooet B,10,40,75,145,105,375,319
5931801,5931801,Cheakamus 11,10,15,10,20,0,55,21
5931802,5931802,Kowtain 17,0,0,0,0,0,0,12
5931806,5931806,Seaichem 16,0,10,10,25,5,50,29
5931807,5931807,Stawamus 24,10,20,40,30,10,110,29
5931808,5931808,Waiwakum 14,10,35,60,45,10,160,46
5931809,5931809,Yekwaupsum 18,0,0,0,0,0,0,12
5931812,5931812,Nesuch 3,10,25,50,40,20,145,53
5931813,5931813,Bridge River 1,15,65,85,55,25,245,91
5931814,5931814,Cayoosh Creek 1,0,5,20,15,15,55,43
5931815,5931815,Chilhil 6,5,10,20,15,5,55,30
5931816,5931816,Fountain 1,5,20,35,40,25,125,48
5931817,5931817,Fountain 3,0,0,0,0,0,0,5
5931818,5931818,Fountain 10,0,0,0,0,0,0,2
5931819,5931819,Fountain 11,0,0,0,0,0,0,1
5931820,5931820,Fountain 12,0,0,0,0,0,0,4
5931821,5931821,Lillooet 1,20,55,80,50,25,230,110
5931822,5931822,Fountain Creek 8,0,0,0,0,0,0,2
5931823,5931823,McCartney's Flat 4,0,0,0,0,0,0,18
5931824,5931824,Seton Lake 5,0,0,0,0,0,0,5
5931826,5931826,Necait 6,0,0,0,0,0,0,9
5931827,5931827,Nesikep 6,0,0,0,0,0,0,3
5931828,5931828,Pashilqua 2,5,10,10,10,0,35,12
5931829,5931829,Pavilion 1,5,5,15,20,5,50,23
5931831,5931831,Slosh 1,15,30,45,65,30,185,90
5931832,5931832,Towinock 2,0,0,0,0,0,0,3
5931833,5931833,Mission 5,0,0,0,0,0,0,11
5931842,5931842,Fountain 1B,0,20,20,15,5,60,22
5931843,5931843,Mount Currie,65,320,485,310,105,1285,433
5931844,5931844,Nequatque,0,25,50,35,20,130,72
5933006,5933006,Merritt,340,1235,1860,2100,1605,7140,3176
5933008,5933008,Thompson-Nicola M (Beautiful Nicola Valley - North),60,190,320,630,400,1600,1049
5933012,5933012,Thompson-Nicola N (Beautiful Nicola Valley - South),25,95,155,325,180,780,439
5933015,5933015,Lytton,20,15,65,80,70,250,139
5933019,5933019,Ashcroft,75,175,290,480,555,1575,801
5933024,5933024,Cache Creek,35,110,205,340,275,965,497
5933028,5933028,Clinton,30,70,120,240,195,655,381
5933032,5933032,Thompson-Nicola E (Bonaparte Plateau),15,75,160,460,390,1100,1352
5933035,5933035,Logan Lake,90,260,385,640,620,1995,1108
5933037,5933037,Thompson-Nicola I (Blue Sky Country),55,170,245,420,375,1265,646
5933039,5933039,Thompson-Nicola J (Copper Desert Country),55,240,325,600,355,1575,998
5933042,5933042,Kamloops,4540,14530,29180,25570,16460,90280,39081
5933044,5933044,Thompson-Nicola P (Rivers and the Peaks),170,505,895,1315,805,3690,1738
5933045,5933045,Sun Peaks Mountain,15,70,255,210,60,610,1146
5933054,5933054,Chase,85,265,390,700,845,2285,1169
5933060,5933060,Thompson-Nicola L (Grasslands),95,380,630,1170,665,2940,1432
5933067,5933067,Clearwater,120,385,590,765,460,2320,1074
5933068,5933068,Thompson-Nicola A (Wells Gray Country),55,175,305,565,395,1495,826
5933070,5933070,Thompson-Nicola B (Thompson Headwaters),15,15,55,100,60,245,222
5933072,5933072,Thompson-Nicola O (Lower North Thompson),40,175,260,505,355,1335,918
5933074,5933074,Barriere,75,240,330,560,495,1700,816
5933801,5933801,Coldwater 1,25,70,105,90,40,330,116
5933802,5933802,Douglas Lake 3,10,20,50,50,25,155,75
5933803,5933803,Hamilton Creek 2,0,0,0,0,0,0,0
5933805,5933805,Joeyaska 2,0,10,15,20,10,55,18
5933806,5933806,Nicola Lake 1,5,25,35,40,20,125,58
5933807,5933807,Nicola Mameet 1,30,140,150,145,55,520,209
5933808,5933808,Nooaitch 10,15,25,40,45,20,145,55
5933809,5933809,Paul's Basin 2,0,0,0,0,0,0,11
5933810,5933810,Chuchhraischin,0,0,0,0,0,0,0
5933811,5933811,Zoht 4,0,0,0,0,0,0,14
5933812,5933812,Bonaparte 3,10,20,25,40,20,115,50
5933813,5933813,Halhalaeden,0,0,0,0,0,0,3
5933814,5933814,Canoe Creek 1,5,20,30,15,0,70,19
5933817,5933817,Skeetchestn,25,60,95,90,30,300,125
5933819,5933819,High Bar 1,0,0,0,0,0,0,1
5933821,5933821,Canoe Creek 2,0,0,0,0,0,0,11
5933823,5933823,Kitzowit 20,0,0,0,0,0,0,7
5933824,5933824,Skuppah 2A,0,0,0,0,0,0,0
5933825,5933825,Inklyuhkinatko 2,0,0,0,0,0,0,14
5933828,5933828,Basque 18,0,0,0,0,0,0,4
5933829,5933829,Klahkamich 17,0,0,0,0,0,0,18
5933831,5933831,Kleetlekut 22,0,0,0,0,0,0,3
5933832,5933832,Klickkumcheen 18,0,15,15,35,15,80,32
5933833,5933833,Inkluckcheen,5,35,35,45,20,140,55
5933834,5933834,Kumcheen 1,0,10,10,5,15,40,18
5933836,5933836,Lower Hat Creek 2,0,0,0,0,0,0,18
5933837,5933837,Peq-Paq 22,0,0,0,0,0,0,0
5933839,5933839,Lytton 4A,0,0,0,0,0,0,0
5933840,5933840,Lytton 4E,0,0,0,0,0,0,3
5933841,5933841,Lytton 9A,0,0,0,0,0,0,5
5933842,5933842,Lytton 9B,0,0,0,0,0,0,1
5933844,5933844,Ashcroft 4,5,15,20,30,5,75,29
5933845,5933845,105 Mile Post 2,0,0,0,0,0,0,4
5933846,5933846,Oregon Jack Creek 5,0,0,0,0,0,0,0
5933848,5933848,Nickel Palm 4,0,0,0,0,0,0,6
5933849,5933849,Siska Flat,5,20,35,15,10,85,39
5933850,5933850,Nickeyeah 25,0,0,0,0,0,0,7
5933851,5933851,Nicomen 1,10,15,20,20,5,70,20
5933852,5933852,Nohomeen 23,0,0,0,0,0,0,1
5933853,5933853,Nuuautin 2,15,35,50,30,5,135,46
5933854,5933854,Paska Island 3,0,0,0,0,0,0,1
5933855,5933855,Papyum 27,0,0,0,0,0,0,9
5933857,5933857,Pemynoos 9,0,0,0,0,0,0,0
5933858,5933858,Seah 5,0,0,0,0,0,0,6
5933859,5933859,Shackan 11,0,10,20,25,10,65,31
5933861,5933861,Kloklowuck 7,0,0,0,0,0,0,4
5933865,5933865,Skuppah 4,0,0,0,0,0,0,4
5933866,5933866,Skwayaynope 26,0,0,0,0,0,0,2
5933868,5933868,Spintlum Flat 3,0,0,0,0,0,0,2
5933870,5933870,Nkaih 10,0,0,0,0,0,0,1
5933872,5933872,Marble Canyon 3,5,20,25,25,10,85,33
5933873,5933873,Stryen 9,5,15,25,15,5,65,22
5933874,5933874,Tsaukan 12,0,0,0,0,0,0,1
5933875,5933875,Upper Hat Creek 1,0,0,0,0,0,0,13
5933876,5933876,Upper Nepa 6,0,0,0,0,0,0,8
5933877,5933877,Whispering Pines 4,5,10,25,15,0,55,18
5933878,5933878,Yawaucht 11,0,0,0,0,0,0,3
5933879,5933879,Zacht 5,0,0,0,0,0,0,3
5933880,5933880,Kamloops 1,105,435,785,1075,620,3020,1518
5933881,5933881,Spences Bridge,0,0,0,0,0,0,5
5933882,5933882,Kanaka Bar,5,15,25,15,5,65,17
5933884,5933884,Sahhaltkum 4,15,90,95,90,20,310,119
5933886,5933886,Nekalliston 2,0,0,0,0,0,0,1
5933887,5933887,North Thompson 1,15,45,65,70,25,220,97
5933888,5933888,Louis Creek 4,0,0,0,0,0,0,8
5933889,5933889,Squaam 2,0,0,0,0,0,0,40
5933895,5933895,Shawniken 4B,0,0,0,0,0,0,9
5933896,5933896,Nekliptum 1,0,0,0,0,0,0,0
5933897,5933897,Boothroyd 8A (Part),0,0,0,0,0,0,0
5933898,5933898,Neskonlith,20,70,80,65,10,245,79
5935010,5935010,Kelowna,5485,19290,40730,35435,26430,127370,57433
5935012,5935012,Central Okanagan,150,540,950,1395,785,3820,1646
5935016,5935016,Lake Country,600,2140,3770,4260,2140,12910,5897
5935018,5935018,Peachland,185,560,1050,1915,1725,5435,2749
5935020,5935020,Central Okanagan J,70,200,445,790,475,1980,1621
5935029,5935029,West Kelowna,1675,5620,8925,9775,6650,32645,13190
5935801,5935801,Duck Lake 7,45,165,310,560,580,1660,1377
5935802,5935802,Tsinstikeptum 9,280,810,1640,2295,2575,7600,3846
5935803,5935803,Tsinstikeptum 10,50,210,350,510,280,1400,615
5937005,5937005,Lumby,120,335,500,515,365,1835,836
5937010,5937010,Coldstream,460,1995,2455,3690,2040,10640,4159
5937014,5937014,Vernon,1790,5865,10820,11420,10225,40120,19170
5937017,5937017,North Okanagan B,130,530,745,1050,735,3190,1533
5937021,5937021,North Okanagan C,170,630,995,1285,775,3855,2245
5937022,5937022,North Okanagan D,125,410,605,1015,525,2680,1236
5937023,5937023,North Okanagan E,45,170,220,375,195,1005,461
5937024,5937024,Spallumcheen,235,865,1180,1785,1040,5105,2089
5937028,5937028,Armstrong,250,825,1280,1445,1330,5130,2143
5937033,5937033,Enderby,165,395,670,875,850,2955,1443
5937041,5937041,North Okanagan F,195,550,935,1495,820,3995,2301
5937801,5937801,Okanagan (Part) 1,80,220,400,910,1245,2855,1900
5937802,5937802,Enderby 2,25,65,85,75,55,305,148
5937803,5937803,Priest's Valley 6,10,35,85,195,315,640,304
5937805,5937805,Harris 3,0,0,0,0,0,0,2
5939007,5939007,Golden,210,575,1330,1030,590,3735,1753
5939011,5939011,Columbia-Shuswap A,155,430,960,1100,510,3155,2068
5939019,5939019,Revelstoke,450,1090,2865,2065,1070,7540,3531
5939023,5939023,Columbia-Shuswap B,20,75,175,240,90,600,466
5939032,5939032,Salmon Arm,765,2790,4140,5110,4900,17705,7838
5939037,5939037,Columbia-Shuswap C,270,900,1360,2780,2615,7925,5010
5939039,5939039,Columbia-Shuswap D,215,605,965,1420,840,4045,1835
5939043,5939043,Columbia-Shuswap E,35,145,240,485,280,1185,1231
5939044,5939044,Columbia-Shuswap F,60,195,320,1025,860,2460,3458
5939045,5939045,Sicamous,80,265,450,935,695,2425,2021
5939801,5939801,Chum Creek 2,0,5,0,25,5,35,31
5939802,5939802,Hustalen 1,0,0,0,0,0,0,44
5939803,5939803,North Bay 5,5,0,0,20,20,45,41
5939804,5939804,Okanagan (Part) 1,0,5,15,30,15,65,39
5939805,5939805,Quaaout 1,10,20,45,65,30,170,239
5939806,5939806,Salmon River 1,0,0,0,0,0,0,17
5939807,5939807,Scotch Creek 4,0,0,0,0,0,0,77
5939808,5939808,Switsemalph 3,5,10,20,15,0,50,22
5939811,5939811,Switsemalph,5,25,25,50,30,135,77
5941005,5941005,One Hundred Mile House,70,310,485,545,575,1985,936
5941009,5941009,Williams Lake,595,1825,3410,2875,2050,10755,5005
5941010,5941010,Cariboo D,125,510,800,1025,480,2940,1350
5941012,5941012,Cariboo E,235,665,1100,1340,725,4065,1821
5941013,5941013,Quesnel,530,1715,2800,2895,1955,9895,4706
5941014,5941014,Cariboo F,205,770,1025,1675,895,4570,2371
5941015,5941015,Cariboo G,200,725,1045,1765,1420,5155,2856
5941016,5941016,Cariboo H,65,200,340,690,485,1780,1438
5941017,5941017,Cariboo L,120,485,645,1645,1305,4200,3482
5941019,5941019,Cariboo A,265,1115,1720,2000,1160,6260,2725
5941021,5941021,Cariboo B,160,635,920,1455,665,3835,1754
5941025,5941025,Wells,15,15,70,75,45,220,158
5941026,5941026,Cariboo C,50,190,320,445,225,1230,635
5941027,5941027,Cariboo I,50,225,305,565,300,1445,692
5941039,5941039,Cariboo J,25,65,125,225,200,640,433
5941041,5941041,Cariboo K,20,60,105,125,90,400,248
5941801,5941801,Alkali Lake 1,30,50,105,90,45,320,122
5941802,5941802,Canim Lake 1,20,45,85,65,15,230,78
5941803,5941803,Canim Lake 4,0,0,0,0,0,0,1
5941804,5941804,Canoe Creek 3,0,0,0,0,0,0,0
5941805,5941805,Deep Creek 2,5,15,20,35,10,85,47
5941806,5941806,Dog Creek 1,0,20,25,15,10,70,35
5941807,5941807,Dog Creek 2,0,0,0,0,0,0,11
5941808,5941808,Lohbiee 3,5,15,30,25,15,90,40
5941809,5941809,Quesnel 1,5,20,35,30,10,100,28
5941810,5941810,Soda Creek 1,5,10,25,20,5,65,15
5941811,5941811,Johny Sticks 2,0,0,0,0,0,0,5
5941812,5941812,Williams Lake 1,10,55,55,50,20,190,84
5941813,5941813,Canim Lake 2,0,0,0,0,0,0,4
5941817,5941817,Alexis Creek 14,0,0,0,0,0,0,1
5941818,5941818,Alexis Creek 16,0,0,0,0,0,0,0
5941821,5941821,Anahim's Flat 1,15,50,110,95,60,330,129
5941827,5941827,Charley Boy's Meadow 3,0,0,0,0,0,0,6
5941828,5941828,Chilco Lake 1,0,0,0,0,0,0,4
5941829,5941829,Chilco Lake 1A,0,0,0,0,0,0,13
5941831,5941831,Tanakut 4,0,0,0,0,0,0,7
5941833,5941833,Kluskus 1,0,0,0,0,0,0,16
5941834,5941834,Louis Squinas Ranch 14,0,0,0,0,0,0,0
5941835,5941835,Coglistiko River 29,0,0,0,0,0,0,0
5941837,5941837,Nazco 20,5,25,25,20,10,85,34
5941838,5941838,Puntzi Lake 2,0,0,0,0,0,0,2
5941839,5941839,Redstone Flat 1,15,45,55,60,15,190,64
5941840,5941840,Squinas 2,0,20,50,40,15,125,65
5941841,5941841,Stone 1,15,40,65,50,20,190,51
5941844,5941844,Agats Meadow 8,0,0,0,0,0,0,1
5941845,5941845,Thomas Squinas Ranch 2A,0,0,0,0,0,0,3
5941848,5941848,Alexis Creek 21,0,0,0,0,0,0,2
5941849,5941849,Baptiste Meadow 2,0,0,0,0,0,0,2
5941850,5941850,Toosey 1,5,20,35,35,10,105,42
5941851,5941851,Towdystan Lake 3,0,0,0,0,0,0,5
5941852,5941852,Trout Lake Alec 16,0,0,0,0,0,0,5
5941854,5941854,Ulkatcho 13,0,0,0,0,0,0,0
5941855,5941855,Windy Mouth 7,0,0,0,0,0,0,3
5941856,5941856,Alexis Creek 34,0,0,0,0,0,0,2
5941858,5941858,Cahoose 10,0,0,0,0,0,0,0
5941859,5941859,Blackwater Meadow 11,0,0,0,0,0,0,0
5941860,5941860,Cahoose 12,0,0,0,0,0,0,0
5941861,5941861,Betty Creek 18,0,0,0,0,0,0,0
5941862,5941862,Salmon River Meadow 7,0,0,0,0,0,0,1
5941863,5941863,Tzetzi Lake 11,0,0,0,0,0,0,0
5941864,5941864,Sundayman's Meadow 3,0,0,0,0,0,0,0
5941866,5941866,Euchinico Creek 17,0,0,0,0,0,0,0
5941868,5941868,Sandy Harry 4,0,0,0,0,0,0,2
5941871,5941871,Fishtrap 19,0,0,0,0,0,0,13
5941872,5941872,Swan Lake 3,0,0,0,0,0,0,3
5941873,5941873,Alkali Lake 4A,0,0,0,0,0,0,3
5941876,5941876,Lezbye 6,0,0,0,0,0,0,7
5941879,5941879,Michel Gardens 36,0,0,0,0,0,0,5
5941880,5941880,Ulkatcho 14A,5,35,50,50,30,170,77
5941881,5941881,Baezaeko River 27,0,0,0,0,0,0,3
5941882,5941882,Alexandria,0,0,0,0,0,0,12
5941883,5941883,Anahim's Meadow,0,0,0,0,0,0,7
5941884,5941884,Garden,0,0,0,0,0,0,3
5941885,5941885,Little Springs,0,0,0,0,0,0,7
5943008,5943008,Alert Bay,25,65,110,155,125,480,281
5943012,5943012,Port McNeill,115,445,745,740,275,2320,1109
5943017,5943017,Port Alice,30,55,155,285,135,660,559
5943023,5943023,Port Hardy,260,770,1235,1270,620,4155,2093
5943027,5943027,Mount Waddington B,0,0,20,25,25,70,193
5943031,5943031,Mount Waddington C,40,85,150,320,145,740,405
5943033,5943033,Mount Waddington D,10,20,40,120,40,230,176
5943037,5943037,Mount Waddington A,30,125,150,345,230,880,573
5943804,5943804,Fort Rupert 1,0,0,0,0,0,0,15
5943806,5943806,Tsulquate 4,35,165,115,90,30,435,115
5943807,5943807,Dead Point 5,0,0,0,0,0,0,7
5943808,5943808,Gwayasdums 1,0,0,0,0,0,0,20
5943809,5943809,Hopetown 10A,0,0,0,0,0,0,0
5943813,5943813,Quaee 7,5,15,35,25,5,85,45
5943815,5943815,Kippase 2,15,50,70,65,25,225,86
5943816,5943816,Quatsino Subdivision 18,15,65,85,45,10,220,80
5943817,5943817,Thomas Point 5,0,0,0,0,0,0,0
5943835,5943835,Nimpkish 2,0,0,0,0,0,0,0
5943836,5943836,Hope Island 1,0,0,0,0,0,0,7
5943837,5943837,Alert Bay,20,95,120,150,85,470,199
5945006,5945006,Central Coast A,0,15,45,115,30,205,156
5945010,5945010,Central Coast C,40,85,150,240,145,660,356
5945012,5945012,Central Coast D,25,60,85,130,95,395,186
5945014,5945014,Central Coast E,10,30,45,30,30,145,83
5945801,5945801,Bella Bella 1,60,210,340,295,105,1010,409
5945802,5945802,Bella Coola 1,65,235,235,190,75,800,295
5945803,5945803,Katit 1,0,0,0,0,0,0,46
5947007,5947007,Port Edward,20,100,115,155,75,465,219
5947012,5947012,Prince Rupert,655,2360,3865,3605,1745,12230,5677
5947016,5947016,Skeena-Queen Charlotte A,0,0,5,30,15,50,44
5947021,5947021,Skeena-Queen Charlotte C,5,5,15,20,10,55,108
5947023,5947023,Masset,55,110,220,260,145,790,464
5947026,5947026,Queen Charlotte,45,120,245,275,165,850,500
5947027,5947027,Skeena-Queen Charlotte D,30,90,145,180,95,540,321
5947030,5947030,Port Clements,5,30,75,110,60,280,174
5947032,5947032,Skeena-Queen Charlotte E,5,45,95,115,75,335,229
5947803,5947803,Masset 1,25,110,160,205,55,555,273
5947804,5947804,Skidegate 1,45,175,255,250,100,825,382
5947806,5947806,Kulkayu (Hartley Bay) 4,5,15,20,10,0,50,37
5947807,5947807,Dolphin Island 1,30,90,115,90,30,355,143
5947809,5947809,Lax Kw'alaams 1,60,150,165,180,80,635,290
5947810,5947810,S1/2 Tsimpsean 2,10,25,20,5,20,80,50
5949005,5949005,Kitimat,450,1355,2460,2570,1295,8130,4244
5949011,5949011,Terrace,710,2185,3805,3220,1735,11655,4906
5949013,5949013,Kitimat-Stikine C (Part 1),130,505,760,985,450,2830,1411
5949018,5949018,Kitimat-Stikine E,235,665,1300,1220,570,3990,1818
5949020,5949020,Kitimat-Stikine C (Part 2),0,0,0,0,0,0,2
5949022,5949022,Hazelton,10,65,65,95,65,300,149
5949024,5949024,New Hazelton,30,100,150,175,120,575,296
5949028,5949028,Kitimat-Stikine B,80,230,330,565,270,1475,751
5949032,5949032,Stewart,20,60,110,130,85,405,292
5949035,5949035,Nisga'a,125,425,565,545,210,1870,677
5949038,5949038,Kitimat-Stikine F,30,60,120,90,50,350,211
5949039,5949039,Kitimat-Stikine A,0,0,0,0,0,0,15
5949041,5949041,Kitimat-Stikine D,10,15,20,20,30,95,83
5949802,5949802,Kitasoo 1,25,55,120,75,25,300,103
5949803,5949803,Kitamaat 2,20,90,145,170,100,525,197
5949804,5949804,Kitsumkaylum 1,20,70,105,90,35,320,111
5949805,5949805,Kshish 4,0,0,0,0,0,0,1
5949807,5949807,Kulspai 6,5,15,20,25,20,85,28
5949810,5949810,Coryatsaqua (Moricetown) 2,5,15,35,15,10,80,40
5949811,5949811,Hagwilget 1,5,45,50,60,20,180,91
5949812,5949812,Gitanmaax 1,35,130,175,200,70,610,235
5949813,5949813,Kispiox 1,55,130,175,145,80,585,217
5949814,5949814,Gitsegukla 1,35,115,110,125,40,425,143
5949815,5949815,Gitanyow 1,30,105,160,105,40,440,136
5949816,5949816,Gitwangak 1,25,100,145,115,60,445,160
5949817,5949817,Moricetown 1,20,65,95,100,30,310,102
5949818,5949818,Sik-e-dakh 2,15,65,75,70,25,250,81
5949819,5949819,Babine 17,10,20,40,30,15,115,41
5949820,5949820,Bulkley River 19,15,45,45,20,15,140,44
5949832,5949832,Iskut 6,20,75,90,85,20,290,124
5949843,5949843,Guhthe Tah 12,5,20,35,50,30,140,64
5949844,5949844,Kitselas 1,30,80,105,45,10,270,79
5949845,5949845,Dease Lake 9,5,20,15,15,10,65,17
5949846,5949846,Tahltan 1,0,0,0,0,0,0,16
5949847,5949847,Telegraph Creek,5,10,15,15,10,55,37
5951007,5951007,Vanderhoof,290,945,1370,1200,640,4445,1831
5951009,5951009,Fraser Lake,50,180,285,290,190,995,551
5951013,5951013,Fort St. James,95,335,520,440,205,1595,761
5951015,5951015,Bulkley-Nechako C,65,235,340,545,220,1405,737
5951017,5951017,Bulkley-Nechako D,65,225,305,555,325,1475,854
5951019,5951019,Bulkley-Nechako F,260,790,945,1180,505,3680,1902
5951022,5951022,Burns Lake,115,360,575,475,260,1785,748
5951028,5951028,Bulkley-Nechako B,85,380,500,650,330,1945,896
5951031,5951031,Bulkley-Nechako E,95,315,350,500,325,1585,840
5951032,5951032,Granisle,5,15,30,100,155,305,284
5951034,5951034,Houston,195,620,835,925,415,2990,1402
5951038,5951038,Telkwa,130,270,420,370,135,1325,539
5951043,5951043,Smithers,295,1055,1780,1425,860,5415,2389
5951051,5951051,Bulkley-Nechako A,300,1060,1420,1755,720,5255,2213
5951053,5951053,Bulkley-Nechako G,45,135,205,360,155,900,450
5951801,5951801,Ye Koo Che 3,20,15,35,15,0,85,42
5951802,5951802,Nautley (Fort Fraser) 1,10,35,75,65,10,195,100
5951803,5951803,Nak'azdli (Necoslie 1),40,115,210,135,50,550,200
5951804,5951804,Sowchea 3,0,0,0,0,0,0,1
5951805,5951805,Binche 2 (Pinchie 2),10,55,70,35,10,180,81
5951806,5951806,Seaspunkut 4,0,0,0,0,0,0,8
5951807,5951807,Stellaquo (Stella) 1,5,55,60,50,20,190,73
5951809,5951809,Stony Creek 1,30,55,105,100,20,310,131
5951810,5951810,Tache 1,30,115,155,80,25,405,114
5951811,5951811,Tacla Lake (Ferry Landing) 9,0,0,0,0,0,0,0
5951813,5951813,Laketown 3,0,0,0,0,0,0,9
5951814,5951814,Dzitline Lee 9,0,0,0,0,0,0,11
5951815,5951815,Burns Lake 18,0,10,15,15,0,40,21
5951818,5951818,Cheslatta 1,10,20,35,10,0,75,53
5951819,5951819,Omineca 1,0,0,0,0,0,0,1
5951820,5951820,Palling 1,0,0,0,0,0,0,4
5951821,5951821,Duncan Lake 2,0,0,0,0,0,0,6
5951822,5951822,Francois Lake 7,0,0,0,0,0,0,6
5951823,5951823,Skins Lake 16A,0,0,0,0,0,0,6
5951824,5951824,Skins Lake 16B,0,0,0,0,0,0,7
5951825,5951825,Tatla West 11,0,0,0,0,0,0,1
5951826,5951826,Uncha Lake 13A,0,0,0,0,0,0,7
5951827,5951827,Woyenne 27,15,40,90,75,15,235,78
5951828,5951828,Babine 6,5,20,30,30,15,100,47
5951829,5951829,Babine 25,15,25,45,20,5,110,48
5951830,5951830,Jean Baptiste 28,0,0,0,0,0,0,5
5951833,5951833,Tatla't East 2,0,0,0,0,0,0,1
5951840,5951840,Williams Prairie Meadow 1A,0,0,0,0,0,0,8
5951844,5951844,Poison Creek 17A,0,0,0,0,0,0,5
5951845,5951845,Tadinlay 15,0,0,0,0,0,0,0
5951846,5951846,Nedoats 11,0,0,0,0,0,0,0
5951847,5951847,Babine Lake 21B,0,0,0,0,0,0,0
5951848,5951848,North Tacla Lake,10,40,70,60,20,200,93
5951849,5951849,Mission Lands 17,0,0,0,0,0,0,0
5953007,5953007,Valemount,50,165,295,335,190,1035,586
5953012,5953012,McBride,40,90,165,195,125,615,326
5953019,5953019,Fraser-Fort George H,65,230,315,590,390,1590,824
5953023,5953023,Prince George,4220,13280,25845,20240,10420,74005,32098
5953033,5953033,Mackenzie,210,670,1230,1190,410,3710,1842
5953038,5953038,Fraser-Fort George A,190,625,1000,1240,400,3455,1536
5953042,5953042,Fraser-Fort George C,170,700,885,1285,495,3535,1354
5953044,5953044,Fraser-Fort George D,195,800,1125,1490,675,4285,1785
5953046,5953046,Fraser-Fort George E,25,85,110,185,130,535,254
5953048,5953048,Fraser-Fort George F,55,205,335,440,210,1245,586
5953050,5953050,Fraser-Fort George G,10,35,50,155,80,330,395
5953801,5953801,Fort George (Shelley) 2,5,20,30,30,15,100,35
5953802,5953802,McLeod Lake 1,0,15,35,35,10,95,45
5955003,5955003,Tumbler Ridge,155,360,600,595,270,1980,1568
5955005,5955005,Pouce Coupe,65,150,265,205,115,800,368
5955010,5955010,Chetwynd,210,475,995,620,210,2510,1294
5955014,5955014,Dawson Creek,910,2180,4630,2910,1560,12190,6020
5955021,5955021,Peace River D,335,1120,1670,1955,835,5915,2450
5955023,5955023,Peace River E,185,535,780,1055,410,2965,1430
5955025,5955025,Hudson's Hope,50,175,260,335,220,1040,545
5955030,5955030,Taylor,125,320,595,330,110,1480,593
5955034,5955034,Fort St. John,1610,3825,9150,4115,1460,20160,9480
5955040,5955040,Peace River B,615,1570,1695,1205,550,5635,1741
5955042,5955042,Peace River C,410,1490,2080,2110,680,6770,2664
5955801,5955801,East Moberly Lake 169,35,100,120,100,10,365,131
5955802,5955802,West Moberly Lake 168A,20,35,55,35,0,145,46
5955803,5955803,Blueberry River 205,10,45,80,50,5,190,71
5955804,5955804,Doig River 206,5,25,30,45,5,110,55
5955807,5955807,Fort Ware 1,35,110,105,60,20,330,128
5955808,5955808,Halfway River 168,15,40,65,40,10,170,61
5955812,5955812,Ingenika Point,20,55,80,50,25,230,101
5957022,5957022,Stikine Region,15,60,150,135,125,485,487
5957802,5957802,Unnamed 10,0,0,0,0,0,0,16
5957803,5957803,Five Mile Point 3,5,25,50,30,15,125,51
5957804,5957804,Good Hope Lake,0,0,0,0,0,0,0
5957813,5957813,Lower Post,5,10,20,25,5,65,40
5957814,5957814,Liard River 3,0,0,20,10,5,35,23
5959007,5959007,Northern Rockies,325,970,1755,1460,325,4835,2317
5959805,5959805,Fontas 1,0,0,0,0,0,0,2
5959806,5959806,Fort Nelson 2,30,100,160,125,35,450,198
5959809,5959809,Kahntah 3,0,0,0,0,0,0,0
5959810,5959810,Prophet River 4,0,25,40,30,5,100,76
6001003,6001003,Watson Lake,45,135,225,270,125,800,447
6001004,6001004,Faro,20,50,105,120,45,340,444
6001006,6001006,Teslin,10,20,30,40,15,115,65
6001007,6001007,Teslin Post 13,5,25,45,55,25,155,86
6001008,6001008,Carcross 4,0,0,0,0,0,0,18
6001009,6001009,Whitehorse,1560,4485,9240,7045,2745,25075,10710
6001010,6001010,Lake Laberge 1,0,0,0,0,0,0,20
6001012,6001012,Carmacks,35,120,145,145,40,485,271
6001016,6001016,Klukshu,0,0,0,0,0,0,44
6001018,6001018,Haines Junction,40,110,190,190,85,615,336
6001019,6001019,Kloo Lake,0,0,0,0,0,0,3
6001022,6001022,Mayo,15,20,60,75,25,195,133
6001029,6001029,Dawson,85,190,520,440,135,1370,756
6001031,6001031,Moosehide Creek 2,0,0,0,0,0,0,27
6001032,6001032,Upper Liard,5,15,35,45,25,125,80
6001035,6001035,Two Mile and Two and One-Half Mile Village,10,40,65,55,15,185,86
6001036,6001036,Tagish,5,10,30,120,70,235,400
6001037,6001037,Ross River,15,55,110,90,20,290,199
6001038,6001038,Champagne Landing 10,0,0,0,0,0,0,42
6001039,6001039,Burwash Landing,0,5,20,30,15,70,74
6001041,6001041,Pelly Crossing,30,60,135,105,40,370,159
6001042,6001042,Beaver Creek,5,10,35,30,20,100,71
6001043,6001043,Old Crow,10,40,75,60,30,215,189
6001044,6001044,Mt. Lorne,20,80,140,150,50,440,219
6001045,6001045,"Yukon, Unorganized",60,185,440,610,220,1515,1216
6001046,6001046,Swift River,0,0,0,0,0,0,0
6001047,6001047,Johnsons Crossing,0,0,0,0,0,0,12
6001048,6001048,Carcross,15,45,85,95,60,300,228
6001049,6001049,Destruction Bay,0,0,25,25,15,65,32
6001050,6001050,Stewart Crossing,0,0,0,0,0,0,20
6001052,6001052,Keno Hill,0,0,0,0,0,0,33
6001055,6001055,Ibex Valley,25,50,145,145,50,415,216
6001057,6001057,Teslin,0,0,0,0,0,0,0
6001058,6001058,Marsh Lake,25,80,175,275,150,705,531
6001059,6001059,Macpherson-Grizzly Valley,80,175,390,445,155,1245,647
6001060,6001060,"Whitehorse, Unorganized",10,45,95,135,35,320,173
6101010,6101010,Tsiigehtchic,20,45,50,40,10,165,79
6101014,6101014,Paulatuk,25,45,115,70,30,285,110
6101015,6101015,Fort McPherson,60,130,230,175,85,680,314
6101017,6101017,Inuvik,295,705,1260,765,225,3250,1477
6101025,6101025,Aklavik,55,130,195,155,60,595,281
6101036,6101036,Tuktoyaktuk,85,225,325,205,60,900,283
6101041,6101041,Sachs Harbour,10,20,35,25,10,100,44
6101063,6101063,"Region 1, Unorganized",0,0,0,0,0,0,5
6101095,6101095,Ulukhaktok,25,105,145,85,45,405,148
6102003,6102003,Déline,45,110,210,130,40,535,239
6102005,6102005,Tulita,30,115,180,120,45,490,183
6102007,6102007,Norman Wells,55,165,310,195,45,770,406
6102009,6102009,Fort Good Hope,40,125,190,100,55,510,238
6102012,6102012,Colville Lake,15,40,30,25,15,125,45
6102063,6102063,"Region 2, Unorganized",0,0,0,0,0,0,0
6103031,6103031,Behchokò,210,545,635,360,135,1885,562
6103034,6103034,Whatì,35,120,195,90,30,470,152
6103049,6103049,Gamètì,15,75,100,60,25,275,96
6103052,6103052,Wekweètì,15,35,60,20,5,135,51
6103097,6103097,"Region 3, Unorganized",0,0,0,0,0,0,0
6104005,6104005,Kakisa,0,0,0,0,0,0,22
6104006,6104006,Sambaa K'e,10,20,25,20,15,90,51
6104009,6104009,Fort Liard,30,125,175,120,50,500,210
6104010,6104010,Nahanni Butte,5,10,25,25,15,80,48
6104013,6104013,Jean Marie River,5,10,20,20,15,70,33
6104014,6104014,Fort Providence,35,120,225,225,75,680,292
6104017,6104017,Hay River Dene 1,25,70,115,65,25,300,111
6104038,6104038,Fort Simpson,70,225,390,400,105,1190,562
6104044,6104044,Wrigley,15,25,30,30,15,115,71
6104097,6104097,"Region 4, Unorganized",5,5,15,15,5,45,95
6105001,6105001,Fort Smith,170,525,900,655,280,2530,1088
6105003,6105003,Enterprise,10,20,35,35,25,125,52
6105004,6105004,Salt Plains 195,0,0,0,0,0,0,21
6105016,6105016,Hay River,220,645,1215,1065,390,3535,1572
6105018,6105018,Fort Resolution,40,85,155,120,70,470,280
6105020,6105020,Lutselk'e,20,75,120,55,30,300,147
6105026,6105026,Reliance,0,0,0,0,0,0,1
6105097,6105097,"Region 5, Unorganized",0,0,0,0,0,0,38
6106021,6106021,Detah,15,45,75,65,25,225,85
6106023,6106023,Yellowknife,1410,3665,8115,5270,1115,19575,7758
6106097,6106097,"Region 6, Unorganized",10,35,70,160,30,305,416
6204001,6204001,Sanikiluaq,110,285,310,140,40,885,231
6204003,6204003,Iqaluit,705,1695,3365,1735,245,7745,3419
6204005,6204005,Kimmirut,45,125,115,70,20,375,139
6204007,6204007,Cape Dorset,190,450,500,235,65,1440,415
6204009,6204009,Pangnirtung,170,455,530,240,90,1485,467
6204010,6204010,Qikiqtarjuaq,75,170,240,110,30,625,187
6204011,6204011,Hall Beach,145,280,295,105,20,845,189
6204012,6204012,Igloolik,225,595,600,210,55,1685,419
6204015,6204015,Clyde River,130,355,390,140,30,1045,288
6204018,6204018,Arctic Bay,125,275,330,105,35,870,227
6204019,6204019,Nanisivik,0,0,0,0,0,0,4
6204020,6204020,Pond Inlet,195,555,565,245,65,1625,406
6204022,6204022,Resolute,25,55,75,25,15,195,82
6204025,6204025,Grise Fiord,10,40,50,25,5,130,62
6204030,6204030,"Baffin, Unorganized",5,20,20,15,0,60,21
6205014,6205014,Coral Harbour,125,315,305,120,30,895,262
6205015,6205015,Arviat,345,900,960,370,90,2665,639
6205016,6205016,Whale Cove,50,155,130,75,25,435,122
6205017,6205017,Rankin Inlet,280,815,1100,550,95,2840,975
6205019,6205019,Chesterfield Inlet,55,140,155,65,15,430,129
6205023,6205023,Baker Lake,230,605,750,380,95,2060,667
6205027,6205027,Naujaat,155,425,350,130,30,1090,213
6205033,6205033,"Keewatin, Unorganized",0,0,0,0,0,0,0
6208047,6208047,Kugaaruk,140,325,315,120,35,935,180
6208059,6208059,Kugluktuk,150,425,530,305,80,1490,469
6208065,6208065,Bathurst Inlet,0,0,0,0,0,0,1
6208068,6208068,Umingmaktok,0,0,0,0,0,0,2
6208073,6208073,Cambridge Bay,160,450,640,430,90,1770,646
6208081,6208081,Gjoa Haven,180,415,475,205,45,1320,311
6208087,6208087,Taloyoak,140,345,360,145,50,1040,261
6208098,6208098,"Kitikmeot, Unorganized",0,0,0,0,0,0,0
