geo_code,alt_geo_code,geo_name,cohort_0_to_4,cohort_5_to_19,cohort_20_to_44,cohort_45_to_64,cohort_65_and_older,total_population,total_dwellings
1,1001,St. John's,10280,33140,73210,58775,30560,205965,92353
5,1005,Bay Roberts,505,1885,2995,3520,2185,11090,4956
10,1010,Grand Falls-Windsor,585,2250,3850,4470,3010,14165,6406
11,1011,Gander,635,2300,3930,3965,2425,13255,6406
15,1015,Corner Brook,1335,4735,8955,10150,6755,31930,14927
105,1105,Charlottetown,3555,11870,22035,19745,12135,69340,32021
110,1110,Summerside,795,2865,4380,4900,3650,16590,7698
205,1205,Halifax,19795,63090,140250,117080,63165,403380,187478
210,1210,Kentville,1205,4365,7070,8205,5385,26230,12275
215,1215,Truro,2110,7515,12395,14005,9735,45760,22478
220,1220,New Glasgow,1595,5610,9015,10785,7485,34490,17035
225,1225,Cape Breton,4180,15010,25500,31490,22545,98725,47205
305,1305,Moncton,7190,23260,48005,41235,25125,144815,66699
310,1310,Saint John,6250,21440,37405,38165,22940,126200,58398
320,1320,Fredericton,5400,17180,33970,28500,16705,101755,46459
328,1328,Bathurst,1075,4140,7530,10770,7595,31110,15385
329,1329,Miramichi,1185,4225,7110,8790,6215,27525,13019
330,1330,Campbellton,605,2245,3865,5450,3580,15745,7636
335,1335,Edmundston,890,3290,5955,7870,5515,23520,11255
403,1403,Matane,720,2340,4360,5825,4680,17925,9583
404,1404,Rimouski,2675,8050,15805,16655,12160,55345,27779
405,1405,Rivière-du-Loup,1460,4470,8245,8410,6335,28920,14010
406,1406,Baie-Comeau,1335,4280,7565,9225,5290,27695,13146
408,1408,Saguenay,8130,23960,46940,48830,33115,160975,77968
410,1410,Alma,1665,5265,8925,10160,6820,32835,15155
411,1411,Dolbeau-Mistassini,740,2445,3870,4920,3695,15670,7443
412,1412,Sept-Îles,1685,5245,8640,8425,4550,28545,13623
421,1421,Québec,42760,120140,259890,223855,153670,800315,382308
423,1423,Sainte-Marie,795,2290,4180,3795,2510,13570,5857
428,1428,Saint-Georges,1825,5355,9420,9550,6360,32510,15022
430,1430,Thetford Mines,1210,3835,6845,8565,7995,28450,14449
433,1433,Sherbrooke,11305,34710,67000,57875,41210,212100,106082
437,1437,Cowansville,665,2115,3860,3965,3060,13665,6272
440,1440,Victoriaville,2530,8020,13720,13705,11180,49155,22553
442,1442,Trois-Rivières,7385,22595,45400,45890,34770,156040,77734
444,1444,Shawinigan,2400,6845,13240,17410,14295,54190,29070
447,1447,Drummondville,5255,16350,28865,27200,18455,96125,44167
450,1450,Granby,4510,13895,23920,25415,17325,85065,40131
452,1452,Saint-Hyacinthe,2925,8935,17230,16840,13680,59610,28605
454,1454,Sorel-Tracy,1715,5235,10425,13155,11095,41625,20856
456,1456,Joliette,2335,7135,13695,14085,12160,49410,23392
462,1462,Montréal,231320,685380,1393375,1117170,671695,4098940,1823281
465,1465,Salaberry-de-Valleyfield,1970,5520,11425,12160,9685,40760,19356
468,1468,Lachute,545,1885,3350,3980,3110,12870,6403
480,1480,Val-d'Or,1980,5920,10430,10145,5385,33860,15674
485,1485,Rouyn-Noranda,2445,7020,13150,12475,7245,42335,20568
501,1501,Cornwall,3080,9400,16315,17500,13390,59685,26936
502,1502,Hawkesbury,460,1690,2865,3820,3135,11970,6093
505,1505,Ottawa - Gatineau,72405,234330,442770,375510,198770,1323785,571146
507,1507,Arnprior,765,2445,4235,4995,3525,15965,7249
509,1509,Carleton Place,1655,5375,8605,9915,5900,31450,13039
512,1512,Brockville,1510,5855,9715,12065,9405,38550,17818
515,1515,Pembroke,1150,3545,6605,6805,5175,23280,10562
516,1516,Petawawa,1565,3140,7775,3310,1400,17190,6747
521,1521,Kingston,7620,25230,51095,45955,31275,161175,77173
522,1522,Belleville,5370,16905,29840,30565,20800,103480,45050
527,1527,Cobourg,735,2680,4360,5570,6100,19445,8958
528,1528,Port Hope,615,2430,4190,5290,4235,16760,7305
529,1529,Peterborough,6025,18525,35435,34705,27040,121730,55662
530,1530,Kawartha Lakes,3095,10755,18140,24365,19070,75425,38444
531,1531,Centre Wellington,1510,5125,7660,8150,5740,28185,11499
532,1532,Oshawa,21570,72235,122090,108445,55495,379835,142462
533,1533,Ingersoll,700,2460,3860,3710,2025,12755,5192
535,1535,Toronto,310070,1042070,2076800,1640520,858590,5928050,2235145
537,1537,Hamilton,39020,127950,235030,212060,133490,747550,306034
539,1539,St. Catharines - Niagara,18360,63905,115345,120055,88405,406070,180606
541,1541,Kitchener - Cambridge - Waterloo,29450,95615,181485,141485,75860,523895,210896
543,1543,Brantford,7495,24265,40615,38200,23635,134210,54419
544,1544,Woodstock,2365,6790,12930,11045,7780,40910,17530
546,1546,Tillsonburg,730,2415,4125,4185,4405,15860,7297
547,1547,Norfolk,3170,10200,16410,19855,14405,64040,28720
550,1550,Guelph,8345,26885,52075,41655,23035,151995,63324
553,1553,Stratford,1420,5085,9090,9355,6540,31490,14302
555,1555,London,25970,84695,162290,136750,84355,494060,220452
556,1556,Chatham-Kent,5275,17580,27180,30555,21460,102050,46287
557,1557,Leamington,2770,8865,14335,13585,9585,49140,19085
559,1559,Windsor,16490,59495,101225,95165,56765,329140,140408
562,1562,Sarnia,4615,15335,27370,28405,20425,96150,44252
565,1565,Wasaga Beach,725,2615,4260,6185,6895,20680,12516
566,1566,Owen Sound,1480,4750,8285,9625,7685,31825,15167
567,1567,Collingwood,945,3195,5730,6180,5740,21790,11617
568,1568,Barrie,10640,37795,64335,56125,28170,197065,76336
569,1569,Orillia,1415,4575,8900,8870,7410,31170,14287
571,1571,Midland,1465,5170,9340,11385,8500,35860,16660
575,1575,North Bay,3330,11075,20640,21270,14055,70370,33696
580,1580,Greater Sudbury,8325,26720,50865,48635,30160,164705,76619
582,1582,Elliot Lake,360,1125,1970,3230,4075,10760,6259
586,1586,Timmins,2280,7420,13130,12610,6345,41785,19317
590,1590,Sault Ste. Marie,3760,11660,22080,23460,17195,78155,36769
595,1595,Thunder Bay,5725,18715,36690,36475,24025,121630,57146
598,1598,Kenora,750,2485,4320,4615,2920,15090,7376
602,1602,Winnipeg,43365,137745,268980,208320,120080,778490,321484
603,1603,Winkler,2660,7465,9910,6505,3730,30270,10539
605,1605,Steinbach,1345,3100,5525,3305,2555,15830,6305
607,1607,Portage la Prairie,930,2500,3890,3500,2495,13315,5794
610,1610,Brandon,3945,10765,21155,13540,8600,58005,25072
640,1640,Thompson,1210,3260,5220,3195,795,13680,5482
705,1705,Regina,15440,42290,86520,60065,32180,236495,101719
710,1710,Yorkton,1105,3445,5685,4930,3740,18905,8505
715,1715,Moose Jaw,2135,6135,10765,9355,6680,35070,16390
720,1720,Swift Current,1060,3150,5755,5030,3535,18530,8393
725,1725,Saskatoon,19675,53665,111290,72565,37900,295095,124766
735,1735,North Battleford,1415,3825,6100,4855,3425,19620,8520
745,1745,Prince Albert,2935,9295,14225,11020,6680,44155,18107
750,1750,Estevan,880,2520,4955,3520,1745,13620,6266
755,1755,Weyburn,685,2000,3535,2570,2065,10855,5135
805,1805,Medicine Hat,4510,14025,24240,21055,12700,76530,33424
806,1806,Brooks,1885,5450,8490,5990,2860,24675,9135
810,1810,Lethbridge,7805,21695,41200,28425,18255,117380,48317
820,1820,Okotoks,1890,7220,9545,7235,2985,28875,9840
821,1821,High River,745,2570,3890,3410,2960,13575,5655
825,1825,Calgary,89110,251825,535745,362920,153005,1392605,544870
826,1826,Strathmore,905,2775,4490,3425,2145,13740,5358
828,1828,Canmore,700,2010,5060,4385,1840,13995,7963
830,1830,Red Deer,6365,18350,38240,25440,12015,100410,42285
831,1831,Sylvan Lake,1205,3230,6010,3555,1295,15295,6914
832,1832,Lacombe,825,2755,4145,3280,2050,13055,5034
833,1833,Camrose,1095,3085,5810,4720,4030,18740,8520
835,1835,Edmonton,85100,233790,503490,336380,162670,1321430,537634
840,1840,Lloydminster,2725,7275,13970,7610,3015,34595,14606
845,1845,Cold Lake,1310,2895,6705,3135,910,14955,6657
850,1850,Grande Prairie,5285,12030,28145,13190,4515,63165,26204
860,1860,Wood Buffalo,6145,12150,34810,18140,2075,73320,31393
865,1865,Wetaskiwin,800,2305,3840,3195,2525,12665,5563
905,1905,Cranbrook,1245,4405,7080,8010,5335,26075,11637
907,1907,Nelson,775,2915,5520,5520,3575,18305,9163
913,1913,Penticton,1530,5765,10065,13455,12615,43430,21603
915,1915,Kelowna,8545,29530,58185,56950,41670,194880,88374
918,1918,Vernon,2640,9285,15510,18555,15350,61340,29311
920,1920,Salmon Arm,775,2820,4185,5185,4930,17895,7937
925,1925,Kamloops,5075,16395,32320,30230,19770,103790,46895
930,1930,Chilliwack,5815,18495,28670,28065,20475,101520,42395
932,1932,Abbotsford - Mission,10755,33850,58340,48115,29465,180525,65967
933,1933,Vancouver,116270,388120,866155,705560,387320,2463425,1027613
934,1934,Squamish,1440,3465,7780,4995,2215,19895,7702
935,1935,Victoria,15730,50875,117245,106155,77775,367780,172559
937,1937,Duncan,2090,7065,10975,13575,10740,44445,19732
938,1938,Nanaimo,4830,15805,30605,30700,22995,104935,46928
939,1939,Parksville,695,2890,4320,8325,12685,28915,14642
940,1940,Port Alberni,1120,3975,6075,7900,6040,25110,12307
943,1943,Courtenay,2205,7885,12735,16575,14770,54170,26140
944,1944,Campbell River,1770,6110,10070,11935,8000,37885,17200
945,1945,Powell River,665,2350,3670,5535,4550,16770,8332
950,1950,Williams Lake,995,3090,5475,5380,3330,18270,8379
952,1952,Quesnel,1090,3970,6220,7495,4360,23135,10768
955,1955,Prince Rupert,675,2460,3985,3760,1810,12690,5896
965,1965,Terrace,950,2870,5115,4455,2330,15720,6752
970,1970,Prince George,4840,15635,29205,24730,12215,86625,37394
975,1975,Dawson Creek,905,2180,4635,2910,1560,12190,6020
977,1977,Fort St. John,2145,5635,11815,6545,2250,28390,12737
990,1990,Whitehorse,1725,4925,10175,8195,3210,28230,12516
995,1995,Yellowknife,1415,3665,8110,5270,1115,19575,7758
1001385,10051001385,Upper Island Cove,60,235,375,565,335,1570,685
1001394,10051001394,Bishop's Cove,5,35,60,105,100,305,147
1001396,10051001396,Spaniard's Bay,125,445,740,840,510,2660,1180
1001409,10051001409,Bay Roberts,300,1090,1670,1815,1130,6005,2658
1001426,10051001426,North River,15,85,150,205,100,555,286
1001485,10011001485,Conception Bay South,1425,4730,8580,7815,3660,26210,10553
1001504,10011001504,Portugal Cove-St. Philip's,495,1530,2615,2475,1035,8150,3215
1001505,10011001505,Pouch Cove,105,400,675,590,295,2065,868
1001507,10011001507,Flatrock,120,315,630,470,155,1690,641
1001509,10011001509,Torbay,445,1605,2755,2290,815,7910,3005
1001511,10011001511,Logy Bay-Middle Cove-Outer Cove,105,410,600,755,350,2220,827
1001512,10011001512,Bauline,30,75,145,145,60,455,174
1001517,10011001517,Paradise,1530,4235,8555,5305,1770,21395,8662
1001519,10011001519,St. John's,4840,15810,39955,30300,17955,108860,52410
1001542,10011001542,Mount Pearl,910,3335,7370,7485,3850,22950,10381
1001551,10011001551,Petty Harbour-Maddox Cove,40,175,300,300,170,985,394
1001557,10011001557,Bay Bulls,100,265,505,395,235,1500,589
1001559,10011001559,Witless Bay,130,265,565,440,230,1630,634
1005010,10151005010,"Division No. 5, Subd. F",30,150,215,295,135,825,687
1005011,10151005011,Steady Brook,10,75,120,140,95,440,204
1005012,10151005012,Pasadena,190,545,935,1205,755,3630,1582
1005015,10151005015,Gillams,20,70,115,140,70,415,190
1005017,10151005017,Massey Drive,90,355,615,475,95,1630,624
1005018,10151005018,Corner Brook,815,2780,5580,6110,4525,19810,9395
1005020,10151005020,Humber Arm South,55,225,435,585,295,1595,721
1005022,10151005022,McIvers,15,90,110,195,125,535,236
1005025,10151005025,Meadows,20,65,155,215,165,620,270
1005028,10151005028,Hughes Brook,15,45,100,75,30,265,94
1005030,10151005030,Irishtown-Summerside,55,195,380,465,330,1425,616
1005033,10151005033,Mount Moriah,30,140,210,265,120,765,308
1006008,10111006008,"Division No. 6, Subd. E",10,20,45,70,50,195,631
1006009,10111006009,Gander,565,2075,3550,3415,2095,11700,5167
1006011,10111006011,Appleton,25,90,140,210,100,565,246
1006012,10111006012,Glenwood,45,125,185,265,160,780,362
1006017,10101006017,Grand Falls-Windsor,590,2250,3845,4470,3020,14175,6406
1102012,11051102012,Lot 49,60,185,315,355,170,1085,483
1102014,11051102014,Lot 48,140,430,620,580,270,2040,811
1102026,11051102026,Lot 31,110,375,505,525,245,1760,676
1102028,11051102028,Lot 65,120,485,645,745,350,2345,1320
1102030,11051102030,Rocky Point 3,5,15,15,15,0,50,19
1102033,11051102033,Meadowbank,10,65,80,125,90,370,200
1102037,11051102037,Clyde River,35,140,165,220,105,665,270
1102040,11051102040,Miltonvale Park,60,170,325,415,180,1150,493
1102048,11051102048,Brackley,15,75,85,135,60,370,148
1102049,11051102049,Lot 33,85,220,395,440,185,1325,667
1102050,11051102050,Union Road,25,30,55,70,30,210,79
1102052,11051102052,Lot 34,185,490,875,855,425,2830,1449
1102054,11051102054,Lot 35,85,280,520,515,235,1635,859
1102056,11051102056,Lot 36,60,140,220,205,120,745,407
1102057,11051102057,Scotchfort 4,20,45,85,40,10,200,63
1102058,11051102058,Lot 37,40,105,200,160,85,590,315
1102059,11051102059,Mount Stewart,5,35,60,65,40,205,114
1102065,11051102065,Winsloe South,10,45,60,75,20,210,86
1102070,11051102070,Warren Grove,20,80,90,130,55,375,140
1102075,11051102075,Charlottetown,1585,5505,11935,9965,7095,36085,17193
1102080,11051102080,Stratford,585,1815,3110,2625,1575,9710,4097
1102085,11051102085,Cornwall,295,1135,1655,1460,805,5350,2132
1103019,11101103019,Lot 17,30,135,165,185,70,585,244
1103023,11101103023,Linkletter,10,55,75,115,55,310,136
1103024,11101103024,Miscouche,55,165,245,240,155,860,372
1103025,11101103025,Summerside,690,2505,3895,4350,3370,14810,6946
1207011,12101207011,"Kings, Subd. C",370,1250,2145,2595,1735,8095,3817
1207012,12101207012,Kentville,295,1040,1760,1770,1385,6250,2891
1207016,12101207016,"Kings, Subd. B",540,2075,3165,3845,2250,11875,5567
1209019,12051209019,Cole Harbour 30,5,20,45,60,80,210,123
1209029,12051209029,Shubenacadie 13,0,0,0,0,0,0,0
1209034,12051209034,Halifax,19785,63055,140200,116995,63095,403130,187338
1209037,12051209037,Beaver Lake 17,0,0,0,0,0,0,5
1209038,12051209038,Sheet Harbour 36,0,0,0,0,0,0,9
1209800,12051209800,Wallace Hills 14A,0,0,0,0,0,0,3
1210001,12151210001,"Colchester, Subd. C",635,2285,3430,4255,2495,13100,6031
1210003,12151210003,Millbrook 27,65,210,300,200,95,870,309
1210006,12151210006,Truro,580,1645,3610,3350,3085,12270,6574
1210008,12151210008,"Colchester, Subd. B",830,3370,5065,6200,4080,19545,9564
1212006,12201212006,"Pictou, Subd. B",265,940,1495,2070,1420,6190,2769
1212008,12201212008,Westville,170,670,1025,1050,705,3620,1698
1212009,12201212009,Stellarton,215,795,1190,1190,820,4210,2018
1212011,12201212011,"Pictou, Subd. C",350,1265,2050,2935,1830,8430,4546
1212014,12201212014,New Glasgow,435,1390,2405,2675,2180,9085,4640
1212016,12201212016,Trenton,130,405,655,785,495,2470,1206
1212019,12201212019,Fisher's Grant 24,35,150,180,90,10,465,158
1212023,12201212023,Merigomish Harbour 31,0,0,0,0,0,0,0
1217008,12251217008,Membertou 28B,95,295,370,195,50,1005,349
1217020,12251217020,Eskasoni 3,395,1070,1180,605,175,3425,1114
1217030,12251217030,Cape Breton,3685,13650,23950,30685,22315,94285,45742
1301001,13101301001,Saint Martins,45,175,285,400,215,1120,609
1301002,13101301002,St. Martins,5,35,60,90,80,270,198
1301004,13101301004,Simonds,195,695,1205,1270,495,3860,1617
1301006,13101301006,Saint John,3245,10330,21025,20005,12965,67570,33801
1301016,13101301016,Musquash,65,170,340,395,220,1190,600
1302008,13101302008,Lepreau,20,80,185,245,195,725,507
1303004,13201303004,Gladstone,20,70,125,160,65,440,239
1303005,13201303005,Tracy,25,100,160,215,115,615,262
1303008,13201303008,Lincoln,460,1190,2540,2190,795,7175,3019
1303016,13201303016,Maugerville,75,335,570,570,280,1830,765
1304001,13101304001,Petersville,30,100,195,220,135,680,325
1305004,13101305004,Upham,75,225,330,420,220,1270,579
1305006,13101305006,Hampton,175,485,790,915,445,2810,1157
1305007,13101305007,Hampton,280,790,1125,1185,920,4300,1709
1305008,13101305008,Rothesay,15,70,90,95,50,320,136
1305011,13101305011,Westfield,80,305,535,710,345,1975,952
1305014,13101305014,Kingston,125,465,740,1010,575,2915,1671
1305015,13101305015,Grand Bay-Westfield,240,885,1415,1570,850,4960,2029
1305016,13101305016,Norton,75,225,360,440,210,1310,536
1305038,13101305038,Greenwich,65,130,260,360,245,1060,560
1305045,13101305045,Rothesay,565,2255,3210,3560,2065,11655,4816
1305057,13101305057,Quispamsis,965,3990,5265,5305,2700,18225,6596
1306001,13051306001,Hopewell,25,90,165,225,140,645,319
1306008,13051306008,Elgin,35,115,190,310,245,895,595
1306011,13051306011,Hillsborough,45,190,330,470,260,1295,649
1306014,13051306014,Coverdale,210,760,1255,1495,750,4470,1806
1306020,13051306020,Riverview,900,3475,5865,5565,3855,19660,8537
1306025,13051306025,Hillsborough,60,215,330,380,300,1285,584
1307011,13051307011,Dorchester,15,70,100,160,80,425,215
1307012,13051307012,Dorchester,15,75,425,430,155,1100,235
1307013,13051307013,Memramcook,235,675,1400,1600,865,4775,2119
1307014,13051307014,Fort Folly 1,0,5,5,15,5,30,22
1307019,13051307019,Moncton,470,1580,2945,3340,1480,9815,4036
1307022,13051307022,Moncton,3615,10855,25005,19660,12745,71880,35380
1307028,13051307028,Salisbury,125,435,635,605,470,2270,974
1307045,13051307045,Dieppe,1400,4570,9135,6685,3585,25375,10829
1308008,13051308008,Saint-Paul,35,140,220,285,155,835,399
1309004,13291309004,Glenelg,60,250,410,500,335,1555,742
1309006,13291309006,Chatham,25,75,135,165,115,515,262
1309011,13291309011,Derby,25,140,210,320,275,970,466
1309014,13291309014,Nelson,30,175,250,320,180,955,431
1309023,13291309023,Red Bank 4,15,60,120,75,30,300,179
1309026,13291309026,Southesk,60,250,435,625,350,1720,834
1309028,13291309028,Northesk,75,335,540,790,500,2240,1068
1309031,13291309031,Newcastle,55,185,270,405,220,1135,522
1309034,13291309034,Big Hole Tract 8 (South Half),5,5,5,10,5,30,33
1309035,13291309035,Eel Ground 2,40,130,185,135,40,530,234
1309050,13291309050,Miramichi,780,2610,4530,5445,4175,17540,8248
1310001,13201310001,New Maryland,155,490,815,795,345,2600,998
1310002,13201310002,New Maryland,215,885,1095,1295,680,4170,1513
1310004,13201310004,Manners Sutton,60,285,395,645,395,1780,1123
1310005,13201310005,Harvey,20,65,90,95,90,360,158
1310017,13201310017,Hanwell,250,1010,1325,1590,590,4765,1856
1310018,13201310018,Kingsclear,155,520,810,890,455,2830,1069
1310019,13201310019,Kingsclear 6,40,125,175,100,35,475,186
1310021,13201310021,Queensbury,45,155,295,435,240,1170,587
1310026,13201310026,Bright,180,605,915,1020,570,3290,1440
1310028,13201310028,Douglas,360,1140,1775,1955,935,6165,2546
1310031,13201310031,Saint Marys,295,955,1510,1515,585,4860,1944
1310032,13201310032,Fredericton,2935,8935,21035,14815,10500,58220,28431
1310034,13201310034,Devon 30,95,300,350,220,65,1030,323
1313014,13351313014,Rivière-Verte,35,90,180,270,150,725,358
1313015,13351313015,Rivière-Verte,35,105,195,265,115,715,346
1313018,13351313018,Saint-Basile,30,85,150,230,90,585,270
1313020,13351313020,St. Basile 10,15,25,60,80,40,220,98
1313022,13351313022,Saint-Joseph,50,225,445,540,275,1535,715
1313024,13351313024,Saint-Jacques,55,225,400,645,280,1605,748
1313027,13351313027,Edmundston,620,2255,4110,5350,4255,16590,8051
1313032,13351313032,Saint-Hilaire,15,100,130,160,70,475,196
1313033,13351313033,St. Hilaire,15,50,90,65,30,250,101
1313034,13351313034,Baker Brook,15,35,65,110,60,285,137
1313035,13351313035,Baker-Brook,15,85,145,180,135,560,235
1314008,13301314008,Dalhousie,35,115,255,415,250,1070,531
1314012,13301314012,Addington,15,90,145,255,165,670,333
1314013,13301314013,Atholville,120,460,910,1325,760,3575,1584
1314014,13301314014,Campbellton,260,940,1585,2280,1820,6885,3443
1314015,13301314015,Tide Head,30,145,230,365,180,950,417
1315008,13281315008,Bathurst,165,655,1215,1765,1005,4805,2292
1315010,13281315010,Pabineau 11,5,35,45,45,15,145,62
1315011,13281315011,Bathurst,420,1515,2725,3810,3425,11895,6317
1315012,13281315012,Beresford,215,870,1630,2335,1185,6235,2780
1315013,13281315013,Pointe-Verte,25,80,180,360,235,880,451
1315014,13281315014,Petit-Rocher,60,225,430,630,540,1885,896
1315015,13281315015,Beresford,145,615,1060,1495,980,4295,2150
1315037,13281315037,Nigadoo,25,145,245,330,215,960,437
2406030,13302406030,Pointe-à-la-Croix,70,190,370,480,290,1400,708
2406804,13302406804,Listuguj,90,320,365,325,155,1255,620
2408023,14032408023,Sainte-Félicité,45,110,215,395,285,1050,635
2408035,14032408035,Saint-René-de-Matane,55,115,235,335,230,970,649
2408053,14032408053,Matane,560,1900,3520,4550,3800,14330,7421
2408073,14032408073,Saint-Ulric,70,210,390,555,360,1585,878
2410015,14042410015,Saint-Narcisse-de-Rimouski,70,130,275,325,165,965,642
2410030,14042410030,Saint-Anaclet-de-Lessard,175,560,965,920,465,3085,1324
2410043,14042410043,Rimouski,2280,6950,13890,14535,10990,48645,24262
2410060,14042410060,Saint-Valérien,50,140,230,270,125,815,422
2410070,14042410070,Saint-Fabien,95,275,450,590,425,1835,1129
2412015,14052412015,Saint-Antonin,260,775,1260,1135,610,4040,1681
2412020,14052412020,Saint-Modeste,100,235,385,295,140,1155,470
2412057,14052412057,Cacouna,105,270,515,540,365,1795,926
2412065,14052412065,Saint-Arsène,90,255,360,325,205,1235,468
2412072,14052412072,Rivière-du-Loup,870,2750,5465,5715,4705,19505,9772
2412080,14052412080,Notre-Dame-du-Portage,30,180,235,405,305,1155,693
2419068,14212419068,Saint-Henri,470,1020,1935,1320,865,5610,2365
2419105,14212419105,Beaumont,215,455,800,755,720,2945,1328
2420005,14212420005,Saint-François-de-l'Île-d'Orléans,20,70,100,195,150,535,384
2420010,14212420010,Sainte-Famille,35,140,195,305,280,955,445
2420015,14212420015,Saint-Jean-de-l'Île-d'Orléans,40,115,245,375,280,1055,681
2420020,14212420020,Saint-Laurent-de-l'Île-d'Orléans,80,210,370,490,380,1530,827
2420025,14212420025,Saint-Pierre-de-l'Île-d'Orléans,80,305,500,595,490,1970,871
2420030,14212420030,Sainte-Pétronille,40,155,215,330,300,1040,495
2421035,14212421035,Château-Richer,305,560,1220,1210,835,4130,1905
2421040,14212421040,L'Ange-Gardien,210,610,1170,1125,560,3675,1625
2421045,14212421045,Boischatel,555,1485,2475,2010,1055,7580,2868
2422005,14212422005,Sainte-Catherine-de-la-Jacques-Cartier,785,1365,2930,1820,810,7710,3063
2422010,14212422010,Fossambault-sur-le-Lac,175,280,575,620,305,1955,1283
2422015,14212422015,Lac-Saint-Joseph,0,25,30,120,90,265,358
2422020,14212422020,Shannon,615,1405,2525,1195,300,6040,2277
2422025,14212422025,Saint-Gabriel-de-Valcartier,310,670,1415,740,275,3410,1204
2422030,14212422030,Lac-Delage,50,155,190,185,65,645,254
2422035,14212422035,Stoneham-et-Tewkesbury,655,1610,2895,2340,860,8360,3924
2422040,14212422040,Lac-Beauport,445,1840,2205,2485,820,7795,3031
2422045,14212422045,Sainte-Brigitte-de-Laval,885,1270,3010,1575,615,7355,3007
2423015,14212423015,Notre-Dame-des-Anges,0,0,0,15,310,325,0
2423027,14212423027,Québec,26430,72635,176885,146385,109580,531915,266409
2423057,14212423057,L'Ancienne-Lorette,680,2790,4545,5140,3365,16520,7120
2423072,14212423072,Saint-Augustin-de-Desmaures,785,3580,4930,6510,3015,18820,7678
2423802,14212423802,Wendake,95,395,635,685,335,2145,973
2425213,14212425213,Lévis,7865,24690,44045,41670,25145,143415,62585
2426030,14232426030,Sainte-Marie,795,2285,4185,3790,2510,13565,5857
2426070,14212426070,Saint-Lambert-de-Lauzon,540,1325,2185,1770,840,6660,2626
2429073,14282429073,Saint-Georges,1830,5370,9415,9545,6365,32525,15022
2431040,14302431040,Irlande,35,135,210,340,170,890,434
2431045,14302431045,Saint-Joseph-de-Coleraine,55,255,400,585,465,1760,1115
2431084,14302431084,Thetford Mines,1100,3375,6165,7490,7280,25410,12691
2431095,14302431095,Saint-Adrien-d'Irlande,20,65,80,150,75,390,209
2433095,14212433095,Saint-Antoine-de-Tilly,80,280,365,500,365,1590,824
2434007,14212434007,Neuville,310,710,1280,1400,680,4380,1898
2436033,14442436033,Shawinigan,2030,5995,11805,16035,13470,49335,26953
2437067,14422437067,Trois-Rivières,6015,19220,39010,39495,30665,134405,67771
2437220,14422437220,Champlain,85,210,430,600,405,1730,927
2437225,14422437225,Saint-Luc-de-Vincennes,30,60,150,175,120,535,278
2437230,14422437230,Saint-Maurice,290,570,1090,910,440,3300,1345
2438010,14422438010,Bécancour,790,2020,3830,3780,2605,13025,6031
2438802,14422438802,Wôlinak,15,45,75,55,25,215,97
2439060,14402439060,Saint-Christophe-d'Arthabaska,200,655,940,865,375,3035,1173
2439062,14402439062,Victoriaville,2325,7360,12780,12845,10820,46130,21380
2441055,14332441055,Ascot Corner,245,640,1005,910,355,3155,1235
2442005,14332442005,Stoke,160,535,855,940,460,2950,1258
2442025,14332442025,Saint-Denis-de-Brompton,320,745,1210,1185,580,4040,1881
2442095,14332442095,Val-Joli,110,270,475,515,240,1610,696
2443027,14332443027,Sherbrooke,8650,26530,53790,42205,30155,161330,80341
2444071,14332444071,Compton,215,565,940,865,535,3120,1342
2444080,14332444080,Waterville,115,475,595,575,365,2125,885
2445050,14332445050,North Hatley,30,75,130,195,220,650,448
2445055,14332445055,Hatley,90,400,490,735,395,2110,928
2445072,14332445072,Magog,1135,3835,6435,8150,7105,26660,14277
2445115,14332445115,Orford,230,630,1055,1595,815,4325,2791
2446078,14502446078,Bromont,485,1625,2480,2775,1670,9035,5198
2446080,14372446080,Cowansville,665,2120,3860,3955,3060,13660,6272
2447010,14502447010,Saint-Alphonse-de-Granby,230,625,1025,945,270,3095,1160
2447017,14502447017,Granby,3405,10440,18520,19555,14320,66240,30880
2447047,14502447047,Roxton Pond,220,700,1105,1205,570,3800,1701
2449020,14472449020,Lefebvre,55,180,285,270,105,895,395
2449025,14472449025,L'Avenir,55,215,315,465,260,1310,640
2449030,14472449030,Saint-Lucien,75,245,465,575,275,1635,947
2449040,14472449040,Wickham,155,530,785,740,335,2545,1030
2449048,14472449048,Saint-Germain-de-Grantham,360,1030,1650,1270,605,4915,1978
2449058,14472449058,Drummondville,3905,12260,22445,21370,15455,75435,35402
2449070,14472449070,Saint-Cyrille-de-Wendover,345,1010,1530,1240,605,4730,1838
2449075,14472449075,Notre-Dame-du-Bon-Conseil,100,245,450,405,360,1560,675
2449080,14472449080,Notre-Dame-du-Bon-Conseil,50,155,235,345,170,955,442
2449095,14472449095,Saint-Majorique-de-Grantham,95,335,430,355,175,1390,514
2449100,14472449100,Saint-Edmond-de-Grantham,65,155,235,195,110,760,306
2451020,14422451020,Yamachiche,160,460,820,875,500,2815,1285
2451085,14442451085,Saint-Boniface,370,850,1445,1360,820,4845,2117
2452007,14622452007,Lavaltrie,890,2565,4405,3925,1865,13650,5507
2453025,14542453025,Sainte-Victoire-de-Sorel,110,385,650,865,440,2450,1127
2453050,14542453050,Saint-Joseph-de-Sorel,70,245,440,540,350,1645,931
2453052,14542453052,Sorel-Tracy,1445,4220,8655,10780,9650,34750,17368
2453065,14542453065,Sainte-Anne-de-Sorel,95,395,665,965,655,2775,1430
2454048,14522454048,Saint-Hyacinthe,2610,8135,15905,15775,13220,55645,27050
2454060,14522454060,Saint-Dominique,185,535,875,665,290,2550,1009
2454090,14522454090,Saint-Simon,125,260,465,395,160,1405,546
2455015,14502455015,Saint-Paul-d'Abbotsford,170,505,810,930,475,2890,1192
2455057,14622455057,Richelieu,260,805,1395,1555,1215,5230,2247
2455065,14622455065,Saint-Mathias-sur-Richelieu,215,785,1335,1415,790,4540,1959
2456083,14622456083,Saint-Jean-sur-Richelieu,5205,15845,29185,27530,17345,95110,42036
2457005,14622457005,Chambly,2105,5920,10110,7460,3525,29120,11546
2457010,14622457010,Carignan,620,1890,3055,2850,1045,9460,3572
2457020,14622457020,Saint-Basile-le-Grand,985,3780,5415,4870,2010,17060,6447
2457025,14622457025,McMasterville,360,1000,1910,1435,985,5690,2332
2457030,14622457030,Otterburn Park,475,1815,2470,2490,1165,8415,3301
2457035,14622457035,Mont-Saint-Hilaire,910,3350,4805,5790,3735,18590,7702
2457040,14622457040,Beloeil,1480,3820,6985,6010,4175,22470,9273
2457045,14622457045,Saint-Mathieu-de-Beloeil,135,465,780,830,405,2615,997
2458007,14622458007,Brossard,4675,13635,27525,22730,17130,85695,34249
2458012,14622458012,Saint-Lambert,890,3635,5040,6155,6150,21870,10446
2458033,14622458033,Boucherville,1680,7390,10340,13130,9130,41670,17134
2458037,14622458037,Saint-Bruno-de-Montarville,1250,5080,6575,7915,5575,26395,10418
2458227,14622458227,Longueuil,13440,36715,78670,68940,41940,239705,110761
2459010,14622459010,Sainte-Julie,1410,6570,8530,8985,4395,29890,11196
2459015,14622459015,Saint-Amable,1025,2430,4730,3015,965,12165,4672
2459020,14622459020,Varennes,1105,4100,6490,6760,2800,21255,8315
2459025,14622459025,Verchères,400,1045,1765,1670,955,5835,2440
2460005,14622460005,Charlemagne,270,700,1680,1990,1280,5920,2962
2460013,14622460013,Repentigny,4170,15260,24130,25780,14940,84280,33876
2460020,14622460020,Saint-Sulpice,170,570,1060,1120,510,3430,1494
2460028,14622460028,L'Assomption,1580,4150,7360,6115,3225,22430,8932
2460035,14622460035,L'Épiphanie,390,1055,1890,1390,755,5480,2240
2460040,14622460040,L'Épiphanie,205,565,975,1040,410,3195,1324
2461005,14562461005,Saint-Paul,420,1080,2045,1605,740,5890,2489
2461025,14562461025,Joliette,980,2785,6075,5880,4755,20475,10285
2461030,14562461030,Notre-Dame-des-Prairies,385,1390,2410,2895,2195,9275,4396
2461035,14562461035,Saint-Charles-Borromée,545,1865,3180,3715,4475,13780,6222
2463048,14622463048,Saint-Lin--Laurentides,1750,3790,7550,5435,2265,20790,8376
2464008,14622464008,Terrebonne,6910,22930,36225,32180,13335,111580,42622
2464015,14622464015,Mascouche,2935,9065,15860,12545,6275,46680,18322
2465005,14622465005,Laval,22420,76585,130235,121170,72595,423005,165686
2466007,14622466007,Montréal-Est,235,590,1400,1120,515,3860,1856
2466023,14622466023,Montréal,98810,248760,657350,426760,273015,1704695,843872
2466032,14622466032,Westmount,785,3640,5305,5325,5260,20315,9617
2466047,14622466047,Montréal-Ouest,265,1035,1330,1585,860,5075,1956
2466058,14622466058,Côte-Saint-Luc,1885,5405,8670,6990,9485,32435,14376
2466062,14622466062,Hampstead,365,1515,1955,1895,1255,6985,2623
2466072,14622466072,Mont-Royal,1095,4390,5545,5390,3865,20285,7914
2466087,14622466087,Dorval,810,2735,6010,5705,3725,18985,8818
2466092,14622466092,L'Île-Dorval,0,0,0,0,0,0,60
2466097,14622466097,Pointe-Claire,1370,5285,7980,9270,7480,31385,12835
2466102,14622466102,Kirkland,705,4050,5190,6910,3300,20155,6779
2466107,14622466107,Beaconsfield,865,4180,4650,6090,3535,19320,6828
2466112,14622466112,Baie-D'Urfé,125,785,750,1245,915,3820,1381
2466117,14622466117,Sainte-Anne-de-Bellevue,150,870,1490,1505,930,4945,2195
2466127,14622466127,Senneville,35,180,190,300,220,925,375
2466142,14622466142,Dollard-Des Ormeaux,2245,9145,14085,14130,9290,48895,17627
2467005,14622467005,Saint-Mathieu,140,360,665,680,295,2140,895
2467010,14622467010,Saint-Philippe,405,1170,2220,1765,745,6305,2627
2467015,14622467015,La Prairie,1220,4925,7315,7160,3500,24120,9947
2467020,14622467020,Candiac,1250,4815,6545,5990,2440,21040,7925
2467025,14622467025,Delson,435,1455,2445,2120,1015,7470,2950
2467030,14622467030,Sainte-Catherine,900,3045,5315,5315,2475,17050,6845
2467035,14622467035,Saint-Constant,1715,5355,9185,8075,3050,27380,10282
2467040,14622467040,Saint-Isidore,155,425,815,795,415,2605,1047
2467045,14622467045,Mercier,900,2665,4235,3575,1740,13115,4932
2467050,14622467050,Châteauguay,2720,8635,14170,13835,8545,47905,19366
2467055,14622467055,Léry,130,340,610,775,460,2315,1052
2467802,14622467802,Kahnawake,0,0,0,0,0,0,
2470022,14622470022,Beauharnois,640,1925,3720,3870,2740,12895,6072
2470052,14652470052,Salaberry-de-Valleyfield,1970,5515,11415,12160,9670,40730,19356
2471025,14622471025,Saint-Zotique,605,1410,2630,2145,1150,7940,3365
2471033,14622471033,Les Coteaux,385,1080,1895,1360,655,5375,2285
2471040,14622471040,Coteau-du-Lac,370,1465,2065,2025,1110,7035,2743
2471050,14622471050,Les Cèdres,430,1305,2200,2065,780,6780,2693
2471055,14622471055,Pointe-des-Cascades,100,225,530,435,190,1480,672
2471060,14622471060,L'Île-Perrot,575,1870,3455,3330,1525,10755,4831
2471065,14622471065,Notre-Dame-de-l'Île-Perrot,550,2355,2920,3625,1190,10640,3843
2471070,14622471070,Pincourt,870,2955,4490,4215,2025,14555,5556
2471075,14622471075,Terrasse-Vaudreuil,100,345,600,620,310,1975,830
2471083,14622471083,Vaudreuil-Dorion,2725,7470,12830,9865,5230,38120,14853
2471090,14622471090,Vaudreuil-sur-le-Lac,55,275,360,420,220,1330,504
2471095,14622471095,L'Île-Cadieux,5,10,15,55,50,135,64
2471100,14622471100,Hudson,175,820,1040,1780,1375,5190,2386
2471105,14622471105,Saint-Lazare,985,4905,5445,6420,2130,19885,6821
2472005,14622472005,Saint-Eustache,2135,7560,12985,13245,8070,43995,18742
2472010,14622472010,Deux-Montagnes,1005,3285,5625,5300,2290,17505,7240
2472015,14622472015,Sainte-Marthe-sur-le-Lac,1480,3485,6460,4535,2120,18080,6941
2472020,14622472020,Pointe-Calumet,440,1160,2165,1905,760,6430,2696
2472025,14622472025,Saint-Joseph-du-Lac,400,1305,2145,2020,795,6665,2608
2472032,14622472032,Oka,195,635,950,1310,720,3810,1636
2472043,14622472043,Saint-Placide,75,250,415,585,360,1685,865
2472802,14622472802,Kanesatake,0,0,0,0,0,0,
2473005,14622473005,Boisbriand,1730,5440,8590,8130,2995,26885,10537
2473010,14622473010,Sainte-Thérèse,1035,3400,7890,7350,6300,25975,12566
2473015,14622473015,Blainville,2965,13020,17375,17350,6165,56875,21006
2473020,14622473020,Rosemère,560,2815,3370,4795,2420,13960,5181
2473025,14622473025,Lorraine,450,2005,2390,3150,1380,9375,3381
2473030,14622473030,Bois-des-Filion,500,1840,3130,2900,1265,9635,4107
2473035,14622473035,Sainte-Anne-des-Plaines,885,2665,4910,4245,1725,14430,5440
2474005,14622474005,Mirabel,3680,10500,18280,13130,4905,50495,20395
2475005,14622475005,Saint-Colomban,1285,3310,5695,4475,1255,16020,6200
2475017,14622475017,Saint-Jérôme,3820,11020,22450,21240,15800,74330,35316
2476020,14682476020,Lachute,550,1880,3350,3970,3105,12855,6403
2476025,14622476025,Gore,85,195,450,790,385,1905,1542
2476055,15022476055,Grenville,90,305,500,480,330,1705,862
2480050,15052480050,Thurso,180,495,895,735,510,2815,1308
2480055,15052480055,Lochaber,20,75,120,145,75,435,183
2480060,15052480060,Lochaber-Partie-Ouest,55,155,270,270,105,855,339
2480065,15052480065,Mayo,30,70,170,225,90,585,403
2480140,15052480140,Val-des-Bois,25,70,130,350,300,875,851
2480145,15052480145,Bowman,25,55,115,280,185,660,546
2481017,15052481017,Gatineau,17195,49070,93480,77880,38625,276250,125608
2482005,15052482005,L'Ange-Gardien,305,1120,1645,1810,595,5475,2058
2482010,15052482010,Notre-Dame-de-la-Salette,25,110,155,285,150,725,473
2482015,15052482015,Val-des-Monts,775,2065,3720,3770,1250,11580,6418
2482020,15052482020,Cantley,700,2340,3555,3195,895,10685,3988
2482025,15052482025,Chelsea,325,1485,1650,2560,865,6885,2898
2482030,15052482030,Pontiac,350,1100,1720,1860,820,5850,2664
2482035,15052482035,La Pêche,395,1270,2135,2695,1350,7845,4665
2483005,15052483005,Denholm,15,65,90,235,90,495,556
2486042,14852486042,Rouyn-Noranda,2445,7015,13150,12475,7240,42325,20568
2489008,14802489008,Val-d'Or,1765,5455,9960,9960,5355,32495,15352
2489804,14802489804,Lac-Simon,210,465,475,185,35,1370,322
2492015,14112492015,Sainte-Jeanne-d'Arc,50,160,265,385,200,1060,511
2492022,14112492022,Dolbeau-Mistassini,670,2215,3540,4395,3440,14260,6719
2492070,14112492070,Saint-Stanislas,20,65,80,145,75,385,213
2493042,14102493042,Alma,1500,4930,8300,9545,6520,30795,14312
2493045,14102493045,Saint-Nazaire,165,340,630,625,320,2080,843
2494068,14082494068,Saguenay,7200,21500,42580,44160,30485,145925,69859
2494225,14082494225,Saint-Félix-d'Otis,45,105,225,375,210,960,771
2494230,14082494230,Sainte-Rose-du-Nord,15,60,90,170,105,440,333
2494235,14082494235,Saint-Fulgence,110,350,550,615,445,2070,1008
2494240,14082494240,Saint-Honoré,455,1070,1930,1550,755,5760,2286
2494245,14082494245,Saint-David-de-Falardeau,125,420,665,1015,560,2785,2102
2494250,14082494250,Bégin,55,125,220,270,160,830,477
2494260,14082494260,Saint-Charles-de-Bourget,35,100,205,260,135,735,354
2494265,14082494265,Larouche,90,225,470,420,265,1470,778
2496020,14062496020,Baie-Comeau,1040,3370,5965,7065,4090,21530,10190
2496025,14062496025,Pointe-Lebel,90,315,500,680,320,1905,949
2496030,14062496030,Pointe-aux-Outardes,80,215,365,460,220,1340,641
2496035,14062496035,Chute-aux-Outardes,75,205,420,550,305,1555,735
2496040,14062496040,Ragueneau,50,180,315,465,320,1330,631
2497007,14122497007,Sept-Îles,1345,4325,7605,7775,4355,25405,12600
2497802,14122497802,Uashat,165,470,525,330,95,1585,499
2497804,14122497804,Maliotenam,180,440,510,315,100,1545,524
3501011,15013501011,South Stormont,590,2245,3420,4340,2515,13110,5277
3501012,15013501012,Cornwall,2485,7155,12900,13165,10885,46590,21659
3502008,15023502008,Hawkesbury,370,1390,2370,3340,2795,10265,5231
3502036,15053502036,Clarence-Rockland,1435,4365,7325,7620,3770,24515,9537
3502048,15053502048,Russell,935,3475,4850,5195,2075,16530,6008
3506008,15053506008,Ottawa,48870,164005,316305,260930,144135,934245,395985
3507006,15123507006,Augusta,285,1225,1855,2395,1585,7345,3004
3507014,15123507014,Elizabethtown-Kitley,355,1555,2335,3345,2255,9845,3988
3507015,15123507015,Brockville,865,3065,5525,6310,5575,21340,10826
3507065,15053507065,North Grenville,745,2945,4400,5490,2875,16455,6658
3509024,15093509024,Beckwith,360,1410,2115,2640,1105,7630,3100
3509028,15093509028,Carleton Place,665,1810,3215,2990,1975,10655,4403
3509030,15093509030,Mississippi Mills,630,2145,3290,4285,2810,13160,5536
3510005,15213510005,Frontenac Islands,45,235,300,655,525,1760,1273
3510010,15213510010,Kingston,5870,19090,41125,33715,24005,123805,59977
3510020,15213510020,South Frontenac,895,3210,4695,6530,3320,18650,9213
3511005,15213511005,Loyalist,805,2690,4990,5070,3410,16965,6710
3512001,15223512001,Tyendinaga,250,800,1255,1445,555,4305,1631
3512005,15223512005,Belleville,2615,8045,14900,14390,10760,50710,22744
3512015,15223512015,Quinte West,2250,7255,12375,13210,8490,43580,18646
3512020,15223512020,Stirling-Rawdon,250,820,1310,1510,985,4875,2029
3514020,15283514020,Port Hope,620,2425,4195,5290,4230,16760,7305
3514021,15273514021,Cobourg,735,2680,4360,5560,6105,19440,8958
3515005,15293515005,Otonabee-South Monaghan,315,970,1685,2280,1410,6660,2944
3515008,15293515008,Hiawatha First Nation,15,55,100,110,75,355,211
3515013,15293515013,Cavan Monaghan,460,1495,2345,2835,1700,8835,3271
3515014,15293515014,Peterborough,4075,12200,25435,21225,18100,81035,36785
3515015,15293515015,Selwyn,755,2520,3895,5685,4215,17070,8404
3515019,15293515019,Curve Lake First Nation 35,60,180,275,360,190,1065,613
3515023,15293515023,Douro-Dummer,350,1110,1700,2200,1360,6720,3434
3516010,15303516010,Kawartha Lakes,3095,10755,18155,24365,19075,75445,38444
3518001,15353518001,Pickering,4550,16660,28700,28420,13445,91775,31630
3518005,15353518005,Ajax,7225,24965,40640,33710,13135,119675,38105
3518009,15323518009,Whitby,7210,27435,40480,36720,16535,128380,44195
3518013,15323518013,Oshawa,8770,27025,51590,45720,26340,159445,64883
3518017,15323518017,Clarington,5590,17775,30030,25995,12620,92010,33384
3518029,15353518029,Uxbridge,870,3995,5410,7145,3745,21165,7946
3519028,15353519028,Vaughan,16265,62535,96990,86975,43475,306240,96657
3519036,15353519036,Markham,17085,59405,106895,95680,49920,328985,106131
3519038,15353519038,Richmond Hill,8555,37585,59835,60590,28455,195020,66465
3519044,15353519044,Whitchurch-Stouffville,3225,8700,14495,12105,7320,45845,15712
3519046,15353519046,Aurora,2725,11295,16540,17655,7245,55460,19381
3519048,15353519048,Newmarket,4335,16650,25945,25745,11555,84230,29315
3519049,15353519049,King,1250,4860,6990,7650,3765,24515,8736
3519054,15353519054,East Gwillimbury,1275,4350,7105,7770,3470,23970,8279
3519070,15353519070,Georgina,2505,7835,14015,14380,6675,45410,18687
3519076,15353519076,Chippewas of Georgina Island First Nation,20,45,65,85,40,255,565
3520005,15353520005,Toronto,136000,407660,1030975,730000,426940,2731575,1179057
3521005,15353521005,Mississauga,35460,134680,239060,210620,101780,721600,248469
3521010,15353521010,Brampton,37520,125545,214145,150160,66275,593645,173428
3521024,15353521024,Caledon,3330,14150,19610,20635,8770,66495,22021
3522012,15353522012,Mono,360,1635,2065,3035,1495,8590,3127
3522014,15353522014,Orangeville,1775,5765,9505,7810,4050,28905,10696
3523001,15503523001,Puslinch,280,1230,1650,2580,1600,7340,2793
3523008,15503523008,Guelph,7505,23215,47070,34780,19230,131800,55927
3523009,15503523009,Guelph/Eramosa,560,2445,3360,4290,2205,12860,4604
3523025,15313523025,Centre Wellington,1515,5130,7670,8155,5735,28205,11499
3524001,15353524001,Oakville,8960,42475,56100,58145,28175,193855,68617
3524002,15373524002,Burlington,9275,32120,54890,51720,35320,183325,72535
3524009,15353524009,Milton,9315,25465,41040,24155,10140,110115,35537
3524015,15353524015,Halton Hills,3050,12995,18020,18925,8180,61170,21475
3525005,15373525005,Hamilton,28275,90970,172310,152450,92910,536915,222918
3526003,15393526003,Fort Erie,1260,4650,7405,10110,7290,30715,15345
3526011,15393526011,Port Colborne,725,2700,4560,5815,4505,18305,9825
3526014,15393526014,Wainfleet,315,1100,1605,2190,1175,6385,2977
3526028,15393526028,Pelham,660,2885,3955,5440,4160,17100,6596
3526032,15393526032,Welland,2445,8250,15105,15355,11135,52290,23323
3526037,15393526037,Thorold,915,3240,6170,5465,3010,18800,8498
3526043,15393526043,Niagara Falls,4070,14360,25665,26125,17835,88055,37265
3526047,15393526047,Niagara-on-the-Lake,590,2280,3675,5555,5405,17505,7964
3526053,15393526053,St. Catharines,6020,20265,40695,37265,28865,133110,59879
3526057,15393526057,Lincoln,1360,4175,6510,6745,4995,23785,8934
3526065,15373526065,Grimsby,1465,4860,7820,7900,5265,27310,10581
3528052,15473528052,Norfolk County,3165,10200,16415,19860,14405,64045,28720
3529005,15433529005,Brant,1885,6720,10005,11230,6860,36700,13687
3529006,15433529006,Brantford,5615,17550,30605,26960,16775,97505,40732
3529020,15433529020,Six Nations (Part) 40,0,0,0,0,0,0,
3530004,15413530004,North Dumfries,545,2110,2915,3190,1460,10220,3564
3530010,15413530010,Cambridge,7410,24675,42550,36385,18895,129915,49388
3530013,15413530013,Kitchener,13715,40525,84595,61995,32390,233220,95495
3530016,15413530016,Waterloo,4735,19155,38000,27935,15170,104995,46096
3530020,15413530020,Wilmot,1305,4005,5955,5465,3815,20545,7612
3530035,15413530035,Woolwich,1740,5155,7475,6520,4115,25005,8741
3531011,15533531011,Stratford,1415,5075,9085,9355,6525,31455,14302
3532004,15463532004,Tillsonburg,730,2410,4125,4195,4410,15870,7297
3532018,15333532018,Ingersoll,705,2460,3865,3705,2020,12755,5192
3532042,15443532042,Woodstock,2370,6780,12935,11045,7775,40905,17530
3534020,15553534020,Central Elgin,525,2190,3170,4265,2460,12610,5324
3534021,15553534021,St. Thomas,2070,6960,11450,10945,7480,38905,17114
3534024,15553534024,Southwold,215,810,1200,1375,820,4420,1655
3536020,15563536020,Chatham-Kent,5240,17470,27065,30445,21425,101645,46103
3536029,15563536029,Moravian 47,30,105,115,100,35,385,184
3537003,15573537003,Leamington,1640,5090,8230,7355,5270,27585,10726
3537013,15573537013,Kingsville,1125,3770,6120,6225,4320,21560,8359
3537028,15593537028,Amherstburg,1045,3990,6070,6860,3975,21940,8951
3537034,15593537034,LaSalle,1480,6180,8590,9295,4635,30180,10793
3537039,15593537039,Windsor,11135,37520,69990,60235,38290,217170,97777
3537048,15593537048,Tecumseh,955,4110,6110,7585,4465,23225,8987
3537064,15593537064,Lakeshore,1880,7685,10455,11185,5405,36610,13900
3538003,15623538003,St. Clair,685,2415,3875,4355,2765,14095,6243
3538025,15623538025,Sarnia 45,45,150,175,175,90,635,274
3538030,15623538030,Sarnia,3410,11115,20780,20770,15530,71605,33324
3538031,15623538031,Point Edward,60,275,510,645,540,2030,995
3538035,15623538035,Plympton-Wyoming,425,1380,2030,2460,1510,7805,3416
3539015,15553539015,Strathroy-Caradoc,1110,3790,5880,5980,4100,20860,8455
3539027,15553539027,Thames Centre,660,2500,3425,4375,2235,13195,5162
3539033,15553539033,Middlesex Centre,900,3595,4545,5230,2985,17255,6139
3539036,15553539036,London,20300,64225,131830,103720,63755,383830,175558
3539047,15553539047,Adelaide-Metcalfe,185,610,805,860,525,2985,1045
3542053,15663542053,Georgian Bluffs,440,1615,2440,3610,2365,10470,5069
3542059,15663542059,Owen Sound,1040,3140,5840,6005,5325,21350,10098
3543007,15353543007,New Tecumseth,1850,6065,10225,9640,6475,34255,13191
3543009,15683543009,Springwater,900,3800,5275,6230,2840,19045,7234
3543014,15353543014,Bradford West Gwillimbury,2565,6785,12445,9475,4055,35325,11918
3543017,15683543017,Innisfil,1995,6610,10985,11325,5640,36555,14875
3543031,15673543031,Collingwood,945,3195,5725,6180,5740,21785,11617
3543042,15683543042,Barrie,7745,27385,48070,38565,19665,141430,54227
3543052,15693543052,Orillia,1415,4575,8900,8865,7390,31145,14287
3543064,15653543064,Wasaga Beach,720,2615,4255,6185,6905,20680,12516
3543071,15713543071,Tay,425,1445,2650,3405,2115,10040,4931
3543072,15713543072,Penetanguishene,340,1270,2365,2840,2140,8955,3990
3543074,15713543074,Midland,695,2455,4315,5140,4250,16855,7739
3547002,15073547002,Arnprior,450,1290,2370,2490,2175,8775,4124
3547003,15073547003,McNab/Braeside,320,1160,1860,2500,1355,7195,3125
3547064,15153547064,Pembroke,680,1955,3985,3755,3500,13875,6685
3547075,15153547075,Laurentian Valley,475,1585,2620,3040,1665,9385,3877
3547076,15163547076,Petawawa,1565,3140,7775,3315,1405,17200,6747
3548027,15753548027,Bonfield,85,280,535,740,340,1980,1052
3548031,15753548031,Chisholm,95,215,345,425,225,1305,623
3548034,15753548034,East Ferris,225,765,1215,1675,855,4735,2084
3548044,15753548044,North Bay,2450,8170,15985,14730,10210,51545,24799
3548094,15753548094,"Nipissing, Unorganized, North Part",55,265,400,710,355,1785,996
3549060,15753549060,Powassan,170,525,830,1040,890,3455,1381
3549066,15753549066,Callander,175,625,965,1325,785,3875,1710
3549071,15753549071,Nipissing,80,215,390,635,385,1705,1051
3552013,15803552013,Markstay-Warren,145,400,725,960,430,2660,1276
3552051,15803552051,Whitefish Lake 6,20,90,115,110,40,375,240
3553005,15803553005,Greater Sudbury / Grand Sudbury,8155,26195,49985,47535,29660,161530,75029
3553040,15803553040,Wahnapitei 11,5,30,35,30,10,110,74
3556027,15863556027,Timmins,2280,7420,13120,12610,6335,41765,19317
3557011,15903557011,Laird,65,140,275,380,195,1055,527
3557041,15823557041,Elliot Lake,360,1125,1960,3225,4070,10740,6259
3557051,15903557051,"Macdonald, Meredith and Aberdeen Additional",105,260,435,530,280,1610,860
3557061,15903557061,Sault Ste. Marie,3465,10815,20790,21880,16400,73350,34485
3557066,15903557066,Prince,40,160,265,355,210,1030,459
3557074,15903557074,Garden River 14,80,280,330,325,115,1130,438
3557075,15903557075,Rankin Location 15D,0,0,0,0,0,0,
3558001,15953558001,Neebing,95,320,515,780,360,2070,1166
3558003,15953558003,Fort William 52,65,260,290,240,115,970,373
3558004,15953558004,Thunder Bay,5015,16455,33070,31775,21600,107915,50388
3558011,15953558011,Oliver Paipoonge,300,1015,1625,1985,1005,5930,2289
3558012,15953558012,Gillies,25,85,110,165,85,470,201
3558016,15953558016,O'Connor,30,110,200,210,110,660,272
3558019,15953558019,Conmee,75,145,235,265,90,810,327
3558028,15953558028,Shuniah,115,335,640,1045,655,2790,2130
3560010,15983560010,Kenora,750,2485,4320,4615,2930,15100,7376
4602044,16054602044,Steinbach,1345,3100,5530,3305,2540,15820,6305
4602069,16024602069,Taché,875,2950,3730,3050,965,11570,3884
4602075,16024602075,Ritchot,445,1360,2315,1870,700,6690,2510
4603047,16034603047,Stanley,835,3240,2775,1805,380,9035,2234
4603050,16034603050,Winkler,1185,2640,4300,2710,1760,12595,4669
4603053,16034603053,Morden,640,1595,2835,1995,1600,8665,3636
4607046,16104607046,Oakland-Wawanesa,120,340,485,485,245,1675,655
4607057,16104607057,Whitehead,95,360,510,495,215,1675,657
4607060,16104607060,Cornwallis,410,855,1750,1065,450,4530,1783
4607062,16104607062,Brandon,3245,8945,18035,11095,7540,48860,21485
4607071,16104607071,Elton,80,265,375,400,155,1275,492
4609029,16074609029,Portage la Prairie,930,2505,3880,3500,2480,13295,5794
4610035,16024610035,Macdonald,445,1610,2215,2075,820,7165,2428
4610052,16024610052,St. François Xavier,90,290,415,435,190,1420,505
4611040,16024611040,Winnipeg,39205,122785,247470,185455,110325,705240,294245
4611042,16024611042,Headingley,130,625,1290,1080,440,3565,1098
4612047,16024612047,Springfield,910,2995,4395,4910,2140,15350,5667
4613032,16024613032,East St. Paul,370,1815,2335,3285,1555,9360,3304
4613037,16024613037,West St. Paul,250,1030,1470,1685,945,5380,1809
4613056,16024613056,St. Clements,500,1895,2785,3905,1795,10880,5359
4613062,16024613062,Brokenhead 4,55,120,170,140,40,525,194
4614015,16024614015,Rosser,80,255,395,430,200,1360,481
4622026,16404622026,Thompson,1210,3255,5220,3195,790,13670,5482
4701021,17504701021,Bienfait,50,140,295,210,65,760,370
4701022,17504701022,Estevan No. 5,70,315,425,400,165,1375,525
4701024,17504701024,Estevan,755,2070,4235,2910,1515,11485,5371
4702047,17554702047,Weyburn,685,2005,3550,2565,2060,10865,5135
4706011,17054706011,Lajord No. 128,90,230,345,400,150,1215,473
4706021,17054706021,Pense No. 160,40,100,155,135,75,505,189
4706022,17054706022,Belle Plaine,5,10,25,25,15,80,43
4706023,17054706023,Pense,40,140,215,140,50,585,228
4706026,17054706026,Sherwood No. 159,40,115,380,300,135,970,325
4706027,17054706027,Regina,14040,37805,79815,53705,29755,215120,93197
4706028,17054706028,Grand Coulee,55,170,240,160,25,650,202
4706029,17054706029,Edenwold No. 158,265,1055,1290,1450,445,4505,1546
4706030,17054706030,White City,285,750,1095,770,190,3090,1036
4706031,17054706031,Pilot Butte,140,445,740,610,200,2135,791
4706032,17054706032,Balgonie,120,435,625,430,140,1750,611
4706033,17054706033,Edenwold,15,50,95,60,15,235,92
4706053,17054706053,Lumsden No. 189,110,350,490,710,285,1945,774
4706054,17054706054,Disley,0,15,20,15,15,65,33
4706055,17054706055,Buena Vista,25,105,145,225,125,625,417
4706056,17054706056,Lumsden,105,355,535,515,305,1815,722
4706057,17054706057,Lumsden Beach,0,0,0,0,0,0,59
4706058,17054706058,Regina Beach,50,155,305,390,260,1160,981
4707038,17154707038,Moose Jaw No. 161,80,185,410,360,130,1165,524
4707039,17154707039,Moose Jaw,2050,5940,10350,8995,6545,33880,15866
4708001,17204708001,Swift Current No. 137,105,425,525,605,265,1925,743
4708004,17204708004,Swift Current,955,2720,5220,4425,3285,16605,7650
4709011,17104709011,Orkney No. 244,90,375,500,660,235,1860,796
4709012,17104709012,Yorkton,960,2950,4975,4080,3375,16340,7394
4709014,17104709014,Ebenezer,15,40,65,55,15,190,79
4709016,17104709016,Springside,40,85,160,120,105,510,236
4711060,17254711060,Thode,5,35,40,70,5,155,101
4711061,17254711061,Dundurn No. 314,190,510,1190,415,100,2405,503
4711063,17254711063,Dundurn,45,140,195,160,70,610,262
4711064,17254711064,Shields,20,40,90,95,50,295,195
4711065,17254711065,Corman Park No. 344,425,1785,2090,3120,1155,8575,3037
4711066,17254711066,Saskatoon,15625,43090,94045,60250,33360,246370,107098
4711067,17254711067,Langham,140,280,540,350,185,1495,568
4711068,17254711068,Warman,1125,2485,4500,2040,865,11015,3874
4711069,17254711069,Blucher No. 343,130,375,560,675,260,2000,808
4711070,17254711070,Martensville,1000,2265,4080,1855,455,9655,3337
4711071,17254711071,Bradwell,15,40,70,30,20,175,65
4711072,17254711072,Allan,50,130,215,165,95,655,274
4711073,17254711073,Dalmeny,145,435,605,455,185,1825,609
4711075,17254711075,Osler,120,315,425,250,120,1230,412
4711076,17254711076,Colonsay No. 342,15,30,70,105,50,270,121
4711077,17254711077,Clavet,45,85,165,90,25,410,144
4711078,17254711078,Meacham,5,20,20,30,20,95,55
4711079,17254711079,Colonsay,30,100,135,120,70,455,207
4711828,17254711828,Whitecap,35,145,160,85,25,450,166
4712054,17254712054,Vanscoy No. 345,150,480,695,1135,380,2840,1221
4712056,17254712056,Delisle,85,225,340,255,135,1040,438
4712058,17254712058,Vanscoy,35,95,165,115,60,470,198
4712059,17254712059,Asquith,50,150,230,145,65,640,261
4712079,17354712079,Battleford,315,850,1295,1170,800,4430,1816
4715018,17254715018,Aberdeen No. 373,125,285,440,420,100,1370,558
4715019,17254715019,Aberdeen,55,145,240,135,55,630,254
4715064,17454715064,Prince Albert No. 461,130,595,1245,1100,500,3570,1122
4715066,17454715066,Prince Albert,2570,7695,11750,8440,5465,35920,15173
4715079,17454715079,Garden River No. 490,50,125,200,225,115,715,304
4715085,17454715085,Albertville,5,10,20,20,10,65,35
4715092,17454715092,Meath Park,10,35,50,35,35,165,82
4715094,17454715094,Buckland No. 491,135,695,850,1155,550,3385,1311
4715848,17454715848,Wahpaton 94A,40,130,85,45,5,305,80
4716027,17354716027,North Battleford,0,0,0,0,0,0,1
4716028,17354716028,North Battleford No. 437,35,150,165,245,135,730,290
4716029,17354716029,North Battleford,1065,2800,4585,3380,2475,14305,6413
4717022,18404717022,Wilton No. 472,125,345,490,455,205,1620,646
4717024,18404717024,Lashburn,90,225,395,185,85,980,386
4717026,18404717026,Marshall,55,115,215,135,35,555,221
4717029,18404717029,Lloydminster (Part),1025,2485,5495,2105,660,11770,4909
4801003,18054801003,Cypress County,485,1720,2205,2425,815,7650,3222
4801006,18054801006,Medicine Hat,3660,11110,20160,17105,11225,63260,27970
4801018,18054801018,Redcliff,365,1190,1870,1525,645,5595,2232
4802011,18104802011,Lethbridge County,885,2820,2980,2575,1095,10355,3129
4802012,18104802012,Lethbridge,5625,15810,33495,22630,15160,92720,39867
4802013,18104802013,Coalhurst,260,575,1025,555,240,2655,970
4802014,18104802014,Nobleford,170,335,435,225,125,1290,427
4802016,18104802016,Barons,30,65,95,95,60,345,148
4802018,18104802018,Picture Butte,160,390,580,370,305,1805,706
4802019,18104802019,Coaldale,680,1705,2585,1975,1280,8225,3070
4802031,18064802031,Newell County,525,1810,2165,2175,870,7545,2627
4802034,18064802034,Brooks,1170,3075,5530,3135,1545,14455,5412
4802036,18064802036,Duchess,95,280,395,230,70,1070,390
4802038,18064802038,Rosemary,45,100,125,75,60,405,150
4802039,18064802039,Bassano,50,190,275,380,315,1210,556
4805018,18264805018,Strathmore,905,2775,4500,3430,2145,13755,5358
4806006,18214806006,High River,750,2570,3895,3410,2970,13595,5655
4806012,18204806012,Okotoks,1890,7215,9545,7245,2980,28875,9840
4806014,18254806014,Rocky View County,1735,8670,10075,13595,5325,39400,13620
4806016,18254806016,Calgary,77985,218730,482020,322085,138405,1239225,489650
4806017,18254806017,Chestermere,1545,4565,7235,5130,1410,19885,6250
4806019,18254806019,Cochrane,1975,4930,9265,6705,2975,25850,10225
4806021,18254806021,Airdrie,5460,13415,25140,13410,4150,61575,22398
4806022,18254806022,Irricana,75,245,390,400,110,1220,479
4806024,18254806024,Beiseker,40,170,235,270,115,830,338
4806026,18254806026,Crossfield,190,620,945,835,395,2985,1168
4806804,18254806804,Tsuu T'ina Nation 145 (Sarcee 145),110,495,455,480,115,1655,742
4808005,18314808005,Jarvis Bay,5,35,40,110,30,220,136
4808011,18304808011,Red Deer,6365,18350,38245,25445,12015,100420,42285
4808012,18314808012,Sylvan Lake,1190,3145,5920,3340,1220,14815,6567
4808013,18314808013,Norglenwold,10,55,50,110,50,275,211
4808031,18324808031,Lacombe,825,2750,4155,3265,2055,13050,5034
4810011,18334810011,Camrose,1095,3080,5810,4725,4025,18735,8520
4810039,18404810039,Lloydminster (Part),1430,4115,7385,4715,2010,19655,8444
4810066,18354810066,Bruderheim,90,255,455,380,135,1315,622
4811002,18654811002,Wetaskiwin,800,2305,3825,3195,2520,12645,5563
4811012,18354811012,Leduc County,775,2665,3910,4455,1985,13790,5960
4811013,18354811013,Beaumont,1560,4120,6715,3975,1015,17385,5980
4811016,18354811016,Leduc,2375,5670,11605,6700,3630,29980,12264
4811018,18354811018,Devon,430,1375,2185,1760,825,6575,2493
4811019,18354811019,Calmar,170,415,795,615,210,2205,861
4811020,18354811020,Sundance Beach,0,15,0,25,20,60,148
4811021,18354811021,Thorsby,95,200,295,250,150,990,428
4811022,18354811022,Itaska Beach,0,0,0,0,0,0,78
4811023,18354811023,Golden Days,5,10,30,70,50,165,293
4811024,18354811024,Warburg,45,135,215,205,170,770,335
4811034,18354811034,Parkland County,1635,6405,8700,11020,4335,32095,12910
4811038,18354811038,Seba Beach,5,15,30,50,60,160,323
4811039,18354811039,Betula Beach,0,0,0,0,0,0,40
4811041,18354811041,Point Alison,0,0,0,0,0,0,31
4811042,18354811042,Lakeview,0,0,0,0,0,0,23
4811044,18354811044,Kapasiwin,0,0,0,0,0,0,41
4811045,18354811045,Wabamun,30,135,190,200,145,700,290
4811046,18354811046,Spring Lake,50,130,210,225,70,685,303
4811048,18354811048,Stony Plain,1085,3335,5625,4325,2800,17170,6954
4811049,18354811049,Spruce Grove,2775,6915,13230,7615,3545,34080,13109
4811052,18354811052,Strathcona County,5370,19835,30570,28535,13740,98050,36354
4811056,18354811056,Fort Saskatchewan,1840,4375,9570,5675,2695,24155,9939
4811059,18354811059,Sturgeon County,1260,4320,6185,6265,2475,20505,7337
4811061,18354811061,Edmonton,60070,155295,374860,229875,112420,932520,387950
4811062,18354811062,St. Albert,3575,12990,20150,18805,10070,65590,24446
4811064,18354811064,Gibbons,255,695,1160,760,285,3155,1223
4811065,18354811065,Redwater,95,360,610,680,325,2070,946
4811066,18354811066,Bon Accord,120,315,545,435,110,1525,578
4811068,18354811068,Morinville,815,2030,3730,2365,925,9865,3611
4811069,18354811069,Legal,120,290,450,310,180,1350,465
4811804,18354811804,Stony Plain 135,185,495,645,275,95,1695,576
4811805,18354811805,Alexander 134,90,360,365,220,70,1105,349
4811806,18354811806,Wabamun 133A,170,595,490,245,75,1575,369
4811807,18354811807,Wabamun 133B,0,0,0,0,0,0,5
4812002,18454812002,Cold Lake,1315,2895,6715,3130,915,14970,6657
4815023,18284815023,Canmore,700,2010,5065,4380,1840,13995,7963
4816037,18604816037,Wood Buffalo,5950,11705,34195,17780,1965,71595,30713
4816817,18604816817,Janvier 194,50,110,140,80,35,415,143
4816821,18604816821,Gregoire Lake 176,15,50,80,35,10,190,74
4816822,18604816822,Gregoire Lake 176A,15,35,50,35,5,140,49
4816831,18604816831,Chipewyan 201A,0,0,0,0,0,0,0
4816849,18604816849,Old Fort 217,0,0,0,0,0,0,0
4816850,18604816850,Allison Bay 219,15,30,35,35,0,115,46
4816852,18604816852,Dog Head 218,10,20,25,30,20,105,49
4816859,18604816859,Fort Mackay,85,185,280,145,50,745,303
4816861,18604816861,Thabacha Náre 196A,0,0,0,0,0,0,16
4819012,18504819012,Grande Prairie,5285,12035,28145,13185,4520,63170,26204
5901022,19055901022,Cranbrook,1005,3405,5725,5730,4175,20040,8799
5901035,19055901035,East Kootenay C,235,995,1360,2275,1165,6030,2836
5901802,19055901802,Isidore's Ranch 4,0,0,0,0,0,0,0
5901805,19055901805,Cassimayooks (Mayook) 5,0,0,0,0,0,0,2
5903015,19075903015,Nelson,455,1750,3500,2890,1985,10580,5061
5903041,19075903041,Central Kootenay E,145,530,980,1305,805,3765,2177
5903043,19075903043,Central Kootenay F,175,625,1050,1330,790,3970,1925
5907041,19135907041,Penticton,1245,4365,8245,10105,9800,33760,16895
5907047,19135907047,Okanagan-Similkameen D,150,765,1100,2160,1690,5865,3019
5907051,19135907051,Okanagan-Similkameen F,65,360,385,780,420,2010,835
5907803,19135907803,Penticton 1,65,270,335,420,700,1790,854
5909020,19305909020,Chilliwack,5065,16065,24670,22805,15175,83780,34038
5909027,19305909027,Harrison Hot Springs,40,160,265,495,515,1475,928
5909032,19305909032,Kent,280,855,1650,1800,1490,6075,2351
5909034,19305909034,Fraser Valley D,115,305,400,465,255,1540,596
5909035,19305909035,Fraser Valley H,50,210,370,750,465,1845,1391
5909036,19305909036,Fraser Valley E,45,180,360,585,380,1550,738
5909052,19325909052,Abbotsford,8475,26445,46265,36360,23840,141385,51770
5909056,19325909056,Mission,2255,7340,11965,11685,5595,38840,14101
5909821,19305909821,Kwawkwawapilt 6,0,10,25,50,235,320,200
5909824,19305909824,Skwah 4,10,45,75,45,15,190,64
5909825,19305909825,Skwali 3,0,0,0,0,0,0,3
5909826,19305909826,Skway 5,5,15,25,25,5,75,34
5909827,19305909827,Soowahlie 14,15,50,85,70,30,250,76
5909830,19305909830,Tzeachten 13,30,145,185,540,1455,2355,1205
5909831,19305909831,Yakweakwioose 12,5,15,10,15,0,45,12
5909832,19305909832,Seabird Island,85,225,245,155,45,755,231
5909833,19305909833,Scowlitz 1,0,0,0,0,0,0,4
5909834,19305909834,Tseatah 2,0,0,0,0,0,0,6
5909835,19305909835,Aitchelitch 9,0,0,0,0,0,0,5
5909837,19305909837,Cheam 1,15,45,80,40,20,200,77
5909838,19305909838,Schelowat 1,0,0,0,0,0,0,4
5909844,19305909844,Popkum 1,0,0,0,0,0,0,3
5909849,19305909849,Skwahla 2,0,0,0,0,0,0,0
5909877,19325909877,Upper Sumas 6,10,35,60,45,15,165,64
5909878,19325909878,Matsqui Main 2,15,30,40,25,5,115,32
5909884,19305909884,Skowkale,35,105,155,190,360,845,381
5909885,19305909885,Squiaala,10,50,55,25,10,150,48
5915001,19335915001,Langley,6645,22510,36000,33575,18555,117285,43720
5915002,19335915002,Langley,1400,3790,8680,7065,4970,25905,12264
5915004,19335915004,Surrey,29090,97790,177755,140270,72985,517890,181159
5915007,19335915007,White Rock,540,2045,4055,6545,6790,19975,10856
5915011,19335915011,Delta,4500,18840,28585,31145,19170,102240,37590
5915015,19335915015,Richmond,8910,29860,64325,61565,33655,198315,77478
5915020,19335915020,Greater Vancouver A,790,3510,6895,3365,1565,16125,8542
5915022,19335915022,Vancouver,24620,74180,262135,172985,97575,631495,309418
5915025,19335915025,Burnaby,10865,32800,87370,64850,36865,232750,98030
5915029,19335915029,New Westminster,3240,8720,26975,21240,10815,70990,34235
5915034,19335915034,Coquitlam,6895,24415,46105,42485,19385,139285,54393
5915036,19335915036,Belcarra,15,105,115,245,155,635,292
5915038,19335915038,Anmore,70,520,580,845,195,2210,723
5915039,19335915039,Port Coquitlam,3005,10520,19425,18195,7475,58620,22586
5915043,19335915043,Port Moody,1855,6305,11095,10215,4085,33555,13318
5915046,19335915046,North Vancouver,4000,16610,23220,27035,15050,85915,32624
5915051,19335915051,North Vancouver,2470,7080,19185,15650,8515,52900,26426
5915055,19335915055,West Vancouver,1175,7785,8575,13135,11805,42475,18649
5915062,19335915062,Bowen Island,165,650,810,1290,770,3685,1915
5915065,19335915065,Lions Bay,50,235,295,470,285,1335,547
5915070,19335915070,Pitt Meadows,1030,3205,5710,5685,2930,18560,7356
5915075,19335915075,Maple Ridge,4590,15235,25450,25065,11910,82250,31400
5915801,19335915801,Semiahmoo,5,20,35,35,30,125,64
5915802,19335915802,Tsawwassen,25,95,195,280,215,810,368
5915803,19335915803,Musqueam 2,80,355,475,455,285,1650,615
5915804,19335915804,Coquitlam 2,0,0,0,0,0,0,0
5915805,19335915805,Coquitlam 1,5,15,10,10,5,45,25
5915806,19335915806,Burrard Inlet 3,95,195,655,630,295,1870,932
5915807,19335915807,Mission 1,30,115,215,150,55,565,178
5915808,19335915808,Capilano 5,85,460,1030,860,500,2935,1433
5915809,19335915809,Barnston Island 3,0,0,0,0,0,0,16
5915810,19335915810,Musqueam 4,0,0,0,0,0,0,4
5915811,19335915811,Seymour Creek 2,5,35,45,40,10,135,40
5915813,19335915813,Katzie 2,5,15,5,10,0,35,15
5915816,19335915816,McMillan Island 6,5,20,25,25,15,90,32
5915825,19335915825,Matsqui 4,0,0,10,55,400,465,286
5915830,19335915830,Katzie 1,15,65,95,65,15,255,83
5915835,19335915835,Langley 5,0,0,0,0,0,0,0
5915840,19335915840,Whonnock 1,0,0,0,0,0,0,1
5917005,19355917005,North Saanich,315,1490,2040,3830,3575,11250,4936
5917010,19355917010,Sidney,370,1255,2115,3160,4765,11665,5960
5917015,19355917015,Central Saanich,700,2480,4140,5215,4285,16820,7121
5917021,19355917021,Saanich,4765,17485,35450,32725,23715,114140,49422
5917030,19355917030,Oak Bay,615,2815,3600,5345,5710,18085,8122
5917034,19355917034,Victoria,2940,7755,34450,22590,18055,85790,49212
5917040,19355917040,Esquimalt,820,2035,6300,5360,3145,17660,8742
5917041,19355917041,Colwood,970,2870,5310,4970,2720,16840,6867
5917042,19355917042,Metchosin,165,670,1085,1775,1020,4715,1932
5917044,19355917044,Langford,2255,6120,12785,9795,4375,35330,14906
5917047,19355917047,View Royal,515,1615,3110,3325,1835,10400,4299
5917049,19355917049,Highlands,100,365,615,830,305,2215,862
5917052,19355917052,Sooke,730,2350,3775,3985,2165,13005,5599
5917054,19355917054,Juan de Fuca (Part 1),190,660,1195,1740,910,4695,2337
5917801,19355917801,Cole Bay 3,30,95,95,90,25,335,97
5917802,19355917802,Union Bay 4,10,15,30,20,10,85,40
5917803,19355917803,East Saanich 2,75,225,290,475,620,1685,796
5917804,19355917804,South Saanich 1,70,240,260,195,55,820,248
5917809,19355917809,Becher Bay 1,0,35,50,35,20,140,54
5917811,19355917811,Esquimalt,0,0,0,0,0,0,
5917812,19355917812,New Songhees 1A,80,235,460,620,440,1835,917
5917819,19355917819,T'Sou-ke,10,50,80,70,20,230,90
5919008,19375919008,North Cowichan,1320,4620,7160,9185,7390,29675,13416
5919012,19375919012,Duncan,220,615,1110,1325,1670,4940,2523
5919013,19375919013,Cowichan Valley D,145,485,745,1110,775,3260,1465
5919051,19375919051,Cowichan Valley E,220,680,1110,1405,710,4125,1720
5919801,19375919801,Halalt 2,15,40,65,45,10,175,39
5919802,19375919802,Squaw-hay-one 11,0,0,0,0,0,0,10
5919803,19375919803,Tsussie 6,15,20,35,20,5,95,27
5919808,19375919808,Kil-pah-las 3,0,0,0,0,0,0,0
5919818,19375919818,Theik 2,0,0,0,0,0,0,9
5919821,19375919821,Tzart-Lam 5,0,0,0,0,0,0,13
5919822,19375919822,Cowichan,155,595,715,440,180,2085,510
5921007,19385921007,Nanaimo,4225,13485,26995,25630,20175,90510,40885
5921008,19385921008,Lantzville,130,560,815,1260,835,3600,1517
5921010,19385921010,Nanaimo A,325,1010,1760,2550,1415,7060,3116
5921016,19385921016,Nanaimo C,95,485,710,1040,470,2800,1097
5921018,19395921018,Parksville,345,1345,2160,3355,5310,12515,6445
5921023,19395921023,Qualicum Beach,155,695,990,2440,4655,8935,4644
5921034,19395921034,Nanaimo G,195,845,1180,2520,2715,7455,3553
5921804,19385921804,Nanaimo Town 1,25,90,125,85,30,355,125
5921805,19385921805,Nanoose,20,65,85,45,20,235,86
5921807,19385921807,Nanaimo River,15,100,120,80,40,355,102
5923008,19405923008,Port Alberni,835,2840,4415,5310,4280,17680,8567
5923033,19405923033,Alberni-Clayoquot B,10,55,95,185,95,440,220
5923035,19405923035,Alberni-Clayoquot D,45,150,280,650,490,1615,1131
5923037,19405923037,Alberni-Clayoquot E,105,435,635,935,635,2745,1257
5923039,19405923039,Alberni-Clayoquot F,60,330,420,675,450,1935,863
5923801,19405923801,Ahahswinis 1,0,30,35,25,25,115,61
5923802,19405923802,Alberni 2,0,0,0,0,0,0,3
5923816,19405923816,Tsahaheh 1,55,135,205,105,45,545,199
5923822,19405923822,Klehkoot 2,0,0,0,0,0,0,6
5924034,19445924034,Campbell River,1545,5325,8805,9985,6935,32595,14810
5924042,19445924042,Strathcona D (Oyster Bay - Buttle Lake),195,615,1000,1645,950,4405,2051
5924804,19445924804,Campbell River 11,10,80,105,135,55,385,154
5924812,19445924812,Quinsam 12,15,60,90,95,35,295,107
5924840,19445924840,Homalco 9,10,30,80,60,15,195,78
5926005,19435926005,Comox,555,2200,3090,4100,4080,14025,6410
5926010,19435926010,Courtenay,1180,3760,6860,7130,6680,25610,12013
5926021,19435926021,Comox Valley A,250,780,1385,2580,2205,7200,4360
5926022,19435926022,Comox Valley B (Lazo North),205,1115,1345,2680,1735,7080,3243
5926801,19435926801,Comox 1,10,25,50,80,60,225,114
5927008,19455927008,Powell River,520,1940,2905,4235,3565,13165,6354
5927012,19455927012,Powell River B,60,190,320,535,445,1550,851
5927016,19455927016,Powell River C,85,215,445,760,550,2055,1110
5927806,19455927806,Sechelt (Part),0,0,0,0,0,0,17
5931006,19345931006,Squamish,1415,3400,7645,4885,2180,19525,7574
5931802,19345931802,Kowtain 17,0,0,0,0,0,0,12
5931806,19345931806,Seaichem 16,0,5,15,15,10,45,29
5931807,19345931807,Stawamus 24,10,20,40,30,20,120,29
5931808,19345931808,Waiwakum 14,15,25,65,35,10,150,46
5931809,19345931809,Yekwaupsum 18,0,0,0,0,0,0,12
5933035,19255933035,Logan Lake,85,255,390,635,625,1990,1108
5933039,19255933039,Thompson-Nicola J (Copper Desert Country),55,235,335,600,365,1590,998
5933042,19255933042,Kamloops,4540,14535,29175,25570,16455,90275,39081
5933044,19255933044,Thompson-Nicola P (Rivers and the Peaks),165,505,885,1315,795,3665,1738
5933045,19255933045,Sun Peaks Mountain,20,70,255,215,65,625,1146
5933054,19255933054,Chase,85,255,395,700,835,2270,1169
5933877,19255933877,Whispering Pines 4,5,0,20,20,5,50,18
5933880,19255933880,Kamloops 1,105,435,790,1075,620,3025,1518
5933884,19255933884,Sahhaltkum 4,10,85,85,85,25,290,119
5935010,19155935010,Kelowna,5485,19285,40730,35435,26435,127370,57433
5935012,19155935012,Central Okanagan,155,540,950,1395,785,3825,1646
5935016,19155935016,Lake Country,605,2145,3770,4255,2145,12920,5897
5935018,19155935018,Peachland,180,560,1045,1920,1730,5435,2749
5935020,19155935020,Central Okanagan J,75,200,455,785,470,1985,1621
5935029,19155935029,West Kelowna,1675,5620,8930,9765,6650,32640,13190
5935801,19155935801,Duck Lake 7,45,165,305,560,585,1660,1377
5935802,19155935802,Tsinstikeptum 9,275,810,1640,2305,2575,7605,3846
5935803,19155935803,Tsinstikeptum 10,55,210,350,515,290,1420,615
5937010,19185937010,Coldstream,460,2000,2455,3695,2050,10660,4159
5937014,19185937014,Vernon,1790,5860,10815,11420,10220,40105,19170
5937017,19185937017,North Okanagan B,130,525,745,1050,745,3195,1533
5937021,19185937021,North Okanagan C,170,640,1000,1280,785,3875,2245
5937801,19185937801,Okanagan (Part) 1,80,220,405,915,1250,2870,1900
5937803,19185937803,Priest's Valley 6,10,35,70,190,315,620,304
5939032,19205939032,Salmon Arm,765,2785,4145,5125,4895,17715,7838
5939808,19205939808,Switsemalph 3,5,15,25,20,5,70,22
5939811,19205939811,Switsemalph,0,25,25,45,40,135,77
5941009,19505941009,Williams Lake,600,1825,3405,2870,2060,10760,5005
5941010,19505941010,Cariboo D,125,505,800,1025,480,2935,1350
5941012,19505941012,Cariboo E,230,660,1105,1335,730,4060,1821
5941013,19525941013,Quesnel,530,1715,2795,2895,1945,9880,4706
5941019,19525941019,Cariboo A,265,1125,1725,2000,1165,6280,2725
5941021,19525941021,Cariboo B,165,630,920,1455,670,3840,1754
5941025,19525941025,Wells,15,10,70,80,35,210,158
5941026,19525941026,Cariboo C,50,195,320,440,235,1240,635
5941027,19525941027,Cariboo I,50,225,300,560,310,1445,692
5941801,19505941801,Alkali Lake 1,30,55,105,90,45,325,122
5941806,19505941806,Dog Creek 1,0,20,25,20,10,75,35
5941807,19505941807,Dog Creek 2,0,0,0,0,0,0,11
5941809,19525941809,Quesnel 1,5,20,40,30,10,105,28
5941810,19505941810,Soda Creek 1,5,10,15,20,15,65,15
5941811,19505941811,Johny Sticks 2,0,0,0,0,0,0,5
5941833,19525941833,Kluskus 1,0,0,0,0,0,0,16
5941835,19525941835,Coglistiko River 29,0,0,0,0,0,0,0
5941837,19525941837,Nazco 20,10,25,35,20,5,95,34
5941852,19525941852,Trout Lake Alec 16,0,0,0,0,0,0,5
5941864,19525941864,Sundayman's Meadow 3,0,0,0,0,0,0,0
5941866,19525941866,Euchinico Creek 17,0,0,0,0,0,0,0
5941868,19505941868,Sandy Harry 4,0,0,0,0,0,0,2
5941872,19505941872,Swan Lake 3,0,0,0,0,0,0,3
5941873,19505941873,Alkali Lake 4A,0,0,0,0,0,0,3
5941881,19525941881,Baezaeko River 27,0,0,0,0,0,0,3
5941882,19525941882,Alexandria,0,0,0,0,0,0,12
5941885,19505941885,Little Springs,0,0,0,0,0,0,7
5947007,19555947007,Port Edward,20,100,120,155,70,465,219
5947012,19555947012,Prince Rupert,655,2360,3855,3605,1735,12210,5677
5949011,19655949011,Terrace,715,2180,3800,3210,1745,11650,4906
5949018,19655949018,Kitimat-Stikine E,230,675,1295,1220,570,3990,1818
5949807,19655949807,Kulspai 6,5,15,20,25,15,80,28
5953023,19705953023,Prince George,4220,13275,25845,20240,10415,73995,32098
5953038,19705953038,Fraser-Fort George A,190,630,995,1245,400,3460,1536
5953042,19705953042,Fraser-Fort George C,170,695,885,1290,485,3525,1354
5953044,19705953044,Fraser-Fort George D,195,805,1115,1495,680,4290,1785
5953048,19705953048,Fraser-Fort George F,55,200,340,445,205,1245,586
5953801,19705953801,Fort George (Shelley) 2,10,25,35,30,10,110,35
5955014,19755955014,Dawson Creek,905,2180,4625,2910,1560,12180,6020
5955030,19775955030,Taylor,130,315,590,325,120,1480,593
5955034,19775955034,Fort St. John,1610,3820,9155,4110,1455,20150,9480
5955042,19775955042,Peace River C,410,1490,2075,2110,685,6770,2664
6001009,19906001009,Whitehorse,1555,4495,9240,7045,2745,25080,10710
6001010,19906001010,Lake Laberge 1,0,0,0,0,0,0,20
6001044,19906001044,Mt. Lorne,20,70,135,150,60,435,219
6001055,19906001055,Ibex Valley,30,50,145,145,55,425,216
6001058,19906001058,Marsh Lake,30,85,170,265,155,705,531
6001059,19906001059,Macpherson-Grizzly Valley,75,170,380,450,160,1235,647
6001060,19906001060,"Whitehorse, Unorganized",10,50,90,135,35,320,173
6106023,19956106023,Yellowknife,1410,3665,8115,5275,1120,19585,7758
